State,Year,Election Type,County,Precinct,Active Voters,Inactive Voters,Total Voters,Ballots Cast,Total Voters Turnout %
Colorado,2018,G,ADAMS,4253001245,397,27,424,290,68.40%
Colorado,2018,G,ADAMS,4255601241,43,7,50,30,60.00%
Colorado,2018,G,ADAMS,4255601246,1183,165,1348,866,64.24%
Colorado,2018,G,ADAMS,4255601247,969,71,1040,776,74.62%
Colorado,2018,G,ADAMS,4255601248,970,119,1089,686,62.99%
Colorado,2018,G,ADAMS,4255601249,355,45,400,263,65.75%
Colorado,2018,G,ADAMS,4255601251,1045,140,1185,761,64.22%
Colorado,2018,G,ADAMS,6243101150,1589,115,1704,1253,73.53%
Colorado,2018,G,ADAMS,6243101151,1396,163,1559,1050,67.35%
Colorado,2018,G,ADAMS,6243101159,1745,73,1818,1388,76.35%
Colorado,2018,G,ADAMS,6243401075,616,85,701,445,63.48%
Colorado,2018,G,ADAMS,6243401076,1216,111,1327,938,70.69%
Colorado,2018,G,ADAMS,6243401077,825,72,897,671,74.80%
Colorado,2018,G,ADAMS,6243401252,1324,101,1425,1075,75.44%
Colorado,2018,G,ADAMS,6245601071,832,87,919,639,69.53%
Colorado,2018,G,ADAMS,6245601072,456,15,471,357,75.80%
Colorado,2018,G,ADAMS,6245601073,1617,70,1687,1335,79.13%
Colorado,2018,G,ADAMS,6245601074,1077,77,1154,871,75.48%
Colorado,2018,G,ADAMS,6245601160,372,11,383,311,81.20%
Colorado,2018,G,ADAMS,6253001152,1143,125,1268,853,67.27%
Colorado,2018,G,ADAMS,6253001153,814,79,893,616,68.98%
Colorado,2018,G,ADAMS,6253001154,58,2,60,42,70.00%
Colorado,2018,G,ADAMS,6253001155,361,36,397,282,71.03%
Colorado,2018,G,ADAMS,6253001156,570,25,595,449,75.46%
Colorado,2018,G,ADAMS,6253001157,903,98,1001,709,70.83%
Colorado,2018,G,ADAMS,6253001226,210,19,229,147,64.19%
Colorado,2018,G,ADAMS,6253001229,1396,545,1941,628,32.35%
Colorado,2018,G,ADAMS,6253001230,1655,297,1952,1044,53.48%
Colorado,2018,G,ADAMS,6253001231,1643,363,2006,1026,51.15%
Colorado,2018,G,ADAMS,6253001232,1799,544,2343,953,40.67%
Colorado,2018,G,ADAMS,6253001233,1402,194,1596,901,56.45%
Colorado,2018,G,ADAMS,6253001234,1163,211,1374,689,50.15%
Colorado,2018,G,ADAMS,6253001235,774,190,964,365,37.86%
Colorado,2018,G,ADAMS,6253001236,1277,197,1474,800,54.27%
Colorado,2018,G,ADAMS,6253001237,1104,210,1314,551,41.93%
Colorado,2018,G,ADAMS,6253001238,1205,162,1367,768,56.18%
Colorado,2018,G,ADAMS,6253001239,1043,159,1202,706,58.74%
Colorado,2018,G,ADAMS,6253001240,1771,254,2025,1206,59.56%
Colorado,2018,G,ADAMS,6253001242,440,60,500,336,67.20%
Colorado,2018,G,ADAMS,6253001243,935,61,996,749,75.20%
Colorado,2018,G,ADAMS,6253001253,593,178,771,306,39.69%
Colorado,2018,G,ADAMS,6253101158,892,99,991,643,64.88%
Colorado,2018,G,ADAMS,6255601161,150,9,159,107,67.30%
Colorado,2018,G,ADAMS,6255601162,959,44,1003,822,81.95%
Colorado,2018,G,ADAMS,6255601163,562,27,589,456,77.42%
Colorado,2018,G,ADAMS,6255601164,447,20,467,382,81.80%
Colorado,2018,G,ADAMS,6255601165,1519,54,1573,1416,90.02%
Colorado,2018,G,ADAMS,6255601166,491,28,519,411,79.19%
Colorado,2018,G,ADAMS,6255601167,573,31,604,479,79.30%
Colorado,2018,G,ADAMS,6255601168,627,14,641,472,73.63%
Colorado,2018,G,ADAMS,6255601169,512,33,545,395,72.48%
Colorado,2018,G,ADAMS,6255601170,1391,213,1604,863,53.80%
Colorado,2018,G,ADAMS,6255601171,1428,123,1551,984,63.44%
Colorado,2018,G,ADAMS,6255601172,246,58,304,157,51.64%
Colorado,2018,G,ADAMS,6255601173,89,9,98,73,74.49%
Colorado,2018,G,ADAMS,6255601174,460,42,502,365,72.71%
Colorado,2018,G,ADAMS,6255601175,1272,186,1458,969,66.46%
Colorado,2018,G,ADAMS,6255601176,495,71,566,373,65.90%
Colorado,2018,G,ADAMS,6255601177,198,0,198,142,71.72%
Colorado,2018,G,ADAMS,6255601178,1,0,1,0,0.00%
Colorado,2018,G,ADAMS,6255601179,0,0,0,0,0.00%
Colorado,2018,G,ADAMS,6255601180,941,86,1027,712,69.33%
Colorado,2018,G,ADAMS,6255601181,1286,183,1469,905,61.61%
Colorado,2018,G,ADAMS,6255601182,777,97,874,551,63.04%
Colorado,2018,G,ADAMS,6255601183,280,28,308,202,65.58%
Colorado,2018,G,ADAMS,6255601184,285,36,321,201,62.62%
Colorado,2018,G,ADAMS,6255601185,568,53,621,459,73.91%
Colorado,2018,G,ADAMS,6255601186,1341,136,1477,933,63.17%
Colorado,2018,G,ADAMS,6255601187,1090,193,1283,760,59.24%
Colorado,2018,G,ADAMS,6255601188,841,85,926,674,72.79%
Colorado,2018,G,ADAMS,6255601189,799,57,856,650,75.93%
Colorado,2018,G,ADAMS,6255601190,1233,126,1359,902,66.37%
Colorado,2018,G,ADAMS,6255601191,1465,211,1676,984,58.71%
Colorado,2018,G,ADAMS,6255601192,905,150,1055,603,57.16%
Colorado,2018,G,ADAMS,6255601193,1204,205,1409,776,55.07%
Colorado,2018,G,ADAMS,6255601194,398,73,471,310,65.82%
Colorado,2018,G,ADAMS,6255601195,484,32,516,399,77.33%
Colorado,2018,G,ADAMS,6255601196,105,51,156,51,32.69%
Colorado,2018,G,ADAMS,6255601197,228,24,252,147,58.33%
Colorado,2018,G,ADAMS,6255601198,656,48,704,529,75.14%
Colorado,2018,G,ADAMS,6255601227,357,17,374,299,79.95%
Colorado,2018,G,ADAMS,6255601228,926,69,995,756,75.98%
Colorado,2018,G,ADAMS,6255601244,837,49,886,707,79.80%
Colorado,2018,G,ADAMS,7213001130,275,40,315,204,64.76%
Colorado,2018,G,ADAMS,7213001140,628,80,708,427,60.31%
Colorado,2018,G,ADAMS,7213001141,1019,145,1164,681,58.51%
Colorado,2018,G,ADAMS,7213001199,752,102,854,539,63.11%
Colorado,2018,G,ADAMS,7213001200,130,6,136,105,77.21%
Colorado,2018,G,ADAMS,7213001201,275,30,305,210,68.85%
Colorado,2018,G,ADAMS,7213001202,510,35,545,372,68.26%
Colorado,2018,G,ADAMS,7213001203,495,45,540,407,75.37%
Colorado,2018,G,ADAMS,7213001204,704,101,805,490,60.87%
Colorado,2018,G,ADAMS,7213001205,1335,130,1465,962,65.67%
Colorado,2018,G,ADAMS,7213001206,1343,113,1456,930,63.87%
Colorado,2018,G,ADAMS,7213001207,681,88,769,511,66.45%
Colorado,2018,G,ADAMS,7213001210,1558,143,1701,1089,64.02%
Colorado,2018,G,ADAMS,7213001211,438,65,503,298,59.24%
Colorado,2018,G,ADAMS,7213001212,569,19,588,444,75.51%
Colorado,2018,G,ADAMS,7213001213,676,40,716,501,69.97%
Colorado,2018,G,ADAMS,7213001214,1038,147,1185,758,63.97%
Colorado,2018,G,ADAMS,7213001215,1213,198,1411,877,62.15%
Colorado,2018,G,ADAMS,7213001225,218,15,233,173,74.25%
Colorado,2018,G,ADAMS,7213101117,1701,173,1874,1038,55.39%
Colorado,2018,G,ADAMS,7213101118,1019,140,1159,615,53.06%
Colorado,2018,G,ADAMS,7213201001,1499,312,1811,894,49.36%
Colorado,2018,G,ADAMS,7213201002,1594,205,1799,1079,59.98%
Colorado,2018,G,ADAMS,7213201003,1613,92,1705,604,35.43%
Colorado,2018,G,ADAMS,7213201004,925,140,1065,561,52.68%
Colorado,2018,G,ADAMS,7213201005,1585,191,1776,1003,56.48%
Colorado,2018,G,ADAMS,7213201006,1105,175,1280,619,48.36%
Colorado,2018,G,ADAMS,7213201007,1310,153,1463,872,59.60%
Colorado,2018,G,ADAMS,7213201008,1034,93,1127,690,61.22%
Colorado,2018,G,ADAMS,7213201009,906,110,1016,676,66.54%
Colorado,2018,G,ADAMS,7213201021,1486,244,1730,883,51.04%
Colorado,2018,G,ADAMS,7213201022,1441,135,1576,1498,95.05%
Colorado,2018,G,ADAMS,7213201023,1047,148,1195,647,54.14%
Colorado,2018,G,ADAMS,7213201119,1314,267,1581,753,47.63%
Colorado,2018,G,ADAMS,7213201120,1284,168,1452,780,53.72%
Colorado,2018,G,ADAMS,7213201121,1150,163,1313,717,54.61%
Colorado,2018,G,ADAMS,7213201122,761,104,865,480,55.49%
Colorado,2018,G,ADAMS,7213201123,1464,253,1717,729,42.46%
Colorado,2018,G,ADAMS,7213201124,1450,222,1672,781,46.71%
Colorado,2018,G,ADAMS,7213201125,964,149,1113,548,49.24%
Colorado,2018,G,ADAMS,7213201126,1663,191,1854,903,48.71%
Colorado,2018,G,ADAMS,7213201127,1076,145,1221,564,46.19%
Colorado,2018,G,ADAMS,7213201128,1692,201,1893,867,45.80%
Colorado,2018,G,ADAMS,7213201129,1474,218,1692,776,45.86%
Colorado,2018,G,ADAMS,7213201208,595,75,670,360,53.73%
Colorado,2018,G,ADAMS,7213201209,787,109,896,499,55.69%
Colorado,2018,G,ADAMS,7213201216,1601,224,1825,1028,56.33%
Colorado,2018,G,ADAMS,7213201217,930,130,1060,624,58.87%
Colorado,2018,G,ADAMS,7213201218,774,112,886,568,64.11%
Colorado,2018,G,ADAMS,7213201219,309,45,354,219,61.86%
Colorado,2018,G,ADAMS,7213201220,0,0,0,0,0.00%
Colorado,2018,G,ADAMS,7213201221,496,68,564,376,66.67%
Colorado,2018,G,ADAMS,7213201222,76,0,76,57,75.00%
Colorado,2018,G,ADAMS,7213201223,0,0,0,0,0.00%
Colorado,2018,G,ADAMS,7213201224,41,6,47,26,55.32%
Colorado,2018,G,ADAMS,7213201254,853,180,1033,471,45.60%
Colorado,2018,G,ADAMS,7213201255,722,87,809,371,45.86%
Colorado,2018,G,ADAMS,7213401027,734,291,1025,367,35.80%
Colorado,2018,G,ADAMS,7213401030,1044,187,1231,612,49.72%
Colorado,2018,G,ADAMS,7213401035,1137,209,1346,542,40.27%
Colorado,2018,G,ADAMS,7213401036,837,76,913,655,71.74%
Colorado,2018,G,ADAMS,7213401042,1007,246,1253,638,50.92%
Colorado,2018,G,ADAMS,7213501010,1395,297,1692,878,51.89%
Colorado,2018,G,ADAMS,7213501011,1651,234,1885,1049,55.65%
Colorado,2018,G,ADAMS,7213501012,1196,141,1337,826,61.78%
Colorado,2018,G,ADAMS,7213501013,1699,269,1968,1112,56.50%
Colorado,2018,G,ADAMS,7213501014,1140,126,1266,790,62.40%
Colorado,2018,G,ADAMS,7213501015,1320,435,1755,744,42.39%
Colorado,2018,G,ADAMS,7213501016,1165,125,1290,847,65.66%
Colorado,2018,G,ADAMS,7213501017,1027,118,1145,716,62.53%
Colorado,2018,G,ADAMS,7213501018,1100,162,1262,682,54.04%
Colorado,2018,G,ADAMS,7213501019,765,113,878,512,58.31%
Colorado,2018,G,ADAMS,7213501020,1267,231,1498,724,48.33%
Colorado,2018,G,ADAMS,7213501024,1316,139,1455,857,58.90%
Colorado,2018,G,ADAMS,7213501025,1321,166,1487,835,56.15%
Colorado,2018,G,ADAMS,7213501026,1635,313,1948,1057,54.26%
Colorado,2018,G,ADAMS,7243101078,575,72,647,434,67.08%
Colorado,2018,G,ADAMS,7243101079,850,52,902,676,74.94%
Colorado,2018,G,ADAMS,7243101085,1180,89,1269,916,72.18%
Colorado,2018,G,ADAMS,7243101086,1094,71,1165,860,73.82%
Colorado,2018,G,ADAMS,7243101088,1328,107,1435,1091,76.03%
Colorado,2018,G,ADAMS,7243101089,1232,302,1534,897,58.47%
Colorado,2018,G,ADAMS,7243101093,1413,258,1671,934,55.89%
Colorado,2018,G,ADAMS,7243101094,1317,136,1453,927,63.80%
Colorado,2018,G,ADAMS,7243101097,1177,96,1273,828,65.04%
Colorado,2018,G,ADAMS,7243101105,188,78,266,96,36.09%
Colorado,2018,G,ADAMS,7243101134,1464,213,1677,968,57.72%
Colorado,2018,G,ADAMS,7243101135,1504,180,1684,1021,60.63%
Colorado,2018,G,ADAMS,7243101136,1081,113,1194,799,66.92%
Colorado,2018,G,ADAMS,7243101137,1500,128,1628,1104,67.81%
Colorado,2018,G,ADAMS,7243101145,1493,155,1648,1055,64.02%
Colorado,2018,G,ADAMS,7243101146,1146,275,1421,774,54.47%
Colorado,2018,G,ADAMS,7243101147,1673,203,1876,1137,60.61%
Colorado,2018,G,ADAMS,7243101149,1153,81,1234,892,72.29%
Colorado,2018,G,ADAMS,7243401037,974,146,1120,502,44.82%
Colorado,2018,G,ADAMS,7243401038,1521,220,1741,949,54.51%
Colorado,2018,G,ADAMS,7243401039,1036,98,1134,727,64.11%
Colorado,2018,G,ADAMS,7243401040,1120,135,1255,752,59.92%
Colorado,2018,G,ADAMS,7243401041,1080,194,1274,714,56.04%
Colorado,2018,G,ADAMS,7243401051,1540,184,1724,1108,64.27%
Colorado,2018,G,ADAMS,7243401052,1696,416,2112,1091,51.66%
Colorado,2018,G,ADAMS,7243401053,1186,81,1267,939,74.11%
Colorado,2018,G,ADAMS,7243401080,1045,84,1129,841,74.49%
Colorado,2018,G,ADAMS,7243401081,1052,98,1150,790,68.70%
Colorado,2018,G,ADAMS,7243401082,963,86,1049,784,74.74%
Colorado,2018,G,ADAMS,7243401083,1168,174,1342,860,64.08%
Colorado,2018,G,ADAMS,7243401084,715,65,780,563,72.18%
Colorado,2018,G,ADAMS,7243401087,1216,466,1682,753,44.77%
Colorado,2018,G,ADAMS,7243401090,1299,436,1735,725,41.79%
Colorado,2018,G,ADAMS,7243401091,1267,299,1566,677,43.23%
Colorado,2018,G,ADAMS,7243401092,1413,163,1576,992,62.94%
Colorado,2018,G,ADAMS,7243401095,1310,134,1444,905,62.67%
Colorado,2018,G,ADAMS,7243401096,1134,92,1226,777,63.38%
Colorado,2018,G,ADAMS,7243401098,1122,102,1224,815,66.58%
Colorado,2018,G,ADAMS,7243401099,833,90,923,577,62.51%
Colorado,2018,G,ADAMS,7243401100,1336,225,1561,874,55.99%
Colorado,2018,G,ADAMS,7243401101,1233,214,1447,844,58.33%
Colorado,2018,G,ADAMS,7243401102,1202,102,1304,841,64.49%
Colorado,2018,G,ADAMS,7243401103,559,240,799,336,42.05%
Colorado,2018,G,ADAMS,7243401104,1066,129,1195,739,61.84%
Colorado,2018,G,ADAMS,7243501031,1376,175,1551,977,62.99%
Colorado,2018,G,ADAMS,7243501032,1132,125,1257,786,62.53%
Colorado,2018,G,ADAMS,7243501033,1528,235,1763,1111,63.02%
Colorado,2018,G,ADAMS,7243501034,1236,134,1370,878,64.09%
Colorado,2018,G,ADAMS,7243501043,1003,55,1058,870,82.23%
Colorado,2018,G,ADAMS,7243501044,1025,197,1222,759,62.11%
Colorado,2018,G,ADAMS,7243501045,754,49,803,617,76.84%
Colorado,2018,G,ADAMS,7243501046,751,42,793,645,81.34%
Colorado,2018,G,ADAMS,7243501047,1116,87,1203,966,80.30%
Colorado,2018,G,ADAMS,7243501048,882,54,936,775,82.80%
Colorado,2018,G,ADAMS,7243501049,1130,131,1261,908,72.01%
Colorado,2018,G,ADAMS,7243501050,967,150,1117,765,68.49%
Colorado,2018,G,ADAMS,7243501054,883,70,953,690,72.40%
Colorado,2018,G,ADAMS,7243501055,830,123,953,672,70.51%
Colorado,2018,G,ADAMS,7243501056,1345,103,1448,1103,76.17%
Colorado,2018,G,ADAMS,7243501057,968,93,1061,780,73.52%
Colorado,2018,G,ADAMS,7243501058,1153,191,1344,916,68.15%
Colorado,2018,G,ADAMS,7243501059,1089,82,1171,915,78.14%
Colorado,2018,G,ADAMS,7243501060,1067,221,1288,853,66.23%
Colorado,2018,G,ADAMS,7243501061,1356,301,1657,1017,61.38%
Colorado,2018,G,ADAMS,7243501062,1007,74,1081,812,75.12%
Colorado,2018,G,ADAMS,7243501063,1138,82,1220,930,76.23%
Colorado,2018,G,ADAMS,7243501064,1448,429,1877,960,51.15%
Colorado,2018,G,ADAMS,7243501065,1054,82,1136,857,75.44%
Colorado,2018,G,ADAMS,7243501066,376,73,449,204,45.43%
Colorado,2018,G,ADAMS,7243501067,619,91,710,457,64.37%
Colorado,2018,G,ADAMS,7243501068,1257,167,1424,972,68.26%
Colorado,2018,G,ADAMS,7243501069,1289,233,1522,964,63.34%
Colorado,2018,G,ADAMS,7243501070,963,83,1046,791,75.62%
Colorado,2018,G,ADAMS,7253001131,806,109,915,404,44.15%
Colorado,2018,G,ADAMS,7253001132,1360,162,1522,832,54.66%
Colorado,2018,G,ADAMS,7253001138,831,95,926,601,64.90%
Colorado,2018,G,ADAMS,7253001139,225,19,244,168,68.85%
Colorado,2018,G,ADAMS,7253001142,965,84,1049,750,71.50%
Colorado,2018,G,ADAMS,7253001143,888,82,970,620,63.92%
Colorado,2018,G,ADAMS,7253001144,1448,167,1615,1003,62.11%
Colorado,2018,G,ADAMS,7253001148,938,139,1077,678,62.95%
Colorado,2018,G,ADAMS,7253101106,1696,362,2058,1074,52.19%
Colorado,2018,G,ADAMS,7253101107,1365,142,1507,895,59.39%
Colorado,2018,G,ADAMS,7253101108,1402,249,1651,882,53.42%
Colorado,2018,G,ADAMS,7253101109,1272,132,1404,858,61.11%
Colorado,2018,G,ADAMS,7253101110,964,97,1061,602,56.74%
Colorado,2018,G,ADAMS,7253101111,1173,143,1316,725,55.09%
Colorado,2018,G,ADAMS,7253101112,1100,133,1233,679,55.07%
Colorado,2018,G,ADAMS,7253101113,1273,137,1410,811,57.52%
Colorado,2018,G,ADAMS,7253101114,995,205,1200,616,51.33%
Colorado,2018,G,ADAMS,7253101115,1160,161,1321,683,51.70%
Colorado,2018,G,ADAMS,7253101116,709,147,856,400,46.73%
Colorado,2018,G,ADAMS,7253101133,1367,153,1520,882,58.03%
Colorado,2018,G,ADAMS,7253101250,795,558,1353,347,25.65%
Colorado,2018,G,ADAMS,7253401028,926,222,1148,577,50.26%
Colorado,2018,G,ADAMS,7253401029,1391,311,1702,749,44.01%
Colorado,2018,G,ALAMOSA,3356202001,771,184,955,564,59.06%
Colorado,2018,G,ALAMOSA,3356202002,814,345,1159,543,46.85%
Colorado,2018,G,ALAMOSA,3356202003,1548,272,1820,1158,63.63%
Colorado,2018,G,ALAMOSA,3356202004,1656,190,1846,1218,65.98%
Colorado,2018,G,ALAMOSA,3356202005,703,91,794,536,67.51%
Colorado,2018,G,ALAMOSA,3356202006,922,204,1126,599,53.20%
Colorado,2018,G,ALAMOSA,3356202007,1581,330,1911,987,51.65%
Colorado,2018,G,ALAMOSA,3356202008,753,54,807,594,73.61%
Colorado,2018,G,ARAPAHOE,1260303101,1245,193,1438,786,54.66%
Colorado,2018,G,ARAPAHOE,1260303102,1200,298,1498,739,49.33%
Colorado,2018,G,ARAPAHOE,1260303103,708,120,828,434,52.42%
Colorado,2018,G,ARAPAHOE,1260303104,678,87,765,402,52.55%
Colorado,2018,G,ARAPAHOE,1260303105,1257,195,1452,905,62.33%
Colorado,2018,G,ARAPAHOE,1260303106,560,204,764,399,52.23%
Colorado,2018,G,ARAPAHOE,1260303107,881,153,1034,663,64.12%
Colorado,2018,G,ARAPAHOE,1260303108,734,67,801,613,76.53%
Colorado,2018,G,ARAPAHOE,1260303109,667,60,727,565,77.72%
Colorado,2018,G,ARAPAHOE,1260303110,516,24,540,447,82.78%
Colorado,2018,G,ARAPAHOE,1260303111,1277,299,1576,902,57.23%
Colorado,2018,G,ARAPAHOE,1260303112,915,113,1028,711,69.16%
Colorado,2018,G,ARAPAHOE,1260303113,645,68,713,559,78.40%
Colorado,2018,G,ARAPAHOE,1260303114,861,359,1220,621,50.90%
Colorado,2018,G,ARAPAHOE,1260303115,1066,194,1260,769,61.03%
Colorado,2018,G,ARAPAHOE,1260303116,1248,197,1445,882,61.04%
Colorado,2018,G,ARAPAHOE,1260303117,1164,299,1463,764,52.22%
Colorado,2018,G,ARAPAHOE,1260303118,826,120,946,640,67.65%
Colorado,2018,G,ARAPAHOE,1260303119,838,73,911,563,61.80%
Colorado,2018,G,ARAPAHOE,1260303120,737,89,826,540,65.38%
Colorado,2018,G,ARAPAHOE,1260303121,579,66,645,454,70.39%
Colorado,2018,G,ARAPAHOE,1260303122,769,78,847,542,63.99%
Colorado,2018,G,ARAPAHOE,1260303123,909,124,1033,704,68.15%
Colorado,2018,G,ARAPAHOE,1260303124,1091,232,1323,792,59.86%
Colorado,2018,G,ARAPAHOE,1260303125,586,253,839,344,41.00%
Colorado,2018,G,ARAPAHOE,1260303129,628,66,694,483,69.60%
Colorado,2018,G,ARAPAHOE,1260303130,979,122,1101,762,69.21%
Colorado,2018,G,ARAPAHOE,1260303131,1036,63,1099,853,77.62%
Colorado,2018,G,ARAPAHOE,1260303132,1070,71,1141,901,78.97%
Colorado,2018,G,ARAPAHOE,1260303133,999,75,1074,827,77.00%
Colorado,2018,G,ARAPAHOE,1260303134,567,32,599,482,80.47%
Colorado,2018,G,ARAPAHOE,1260303135,390,18,408,338,82.84%
Colorado,2018,G,ARAPAHOE,1260303136,850,36,886,763,86.12%
Colorado,2018,G,ARAPAHOE,1260303140,443,50,493,337,68.36%
Colorado,2018,G,ARAPAHOE,1263803141,483,8,491,422,85.95%
Colorado,2018,G,ARAPAHOE,1310903137,908,61,969,765,78.95%
Colorado,2018,G,ARAPAHOE,1310903138,411,38,449,343,76.39%
Colorado,2018,G,ARAPAHOE,1310903139,687,67,754,559,74.14%
Colorado,2018,G,ARAPAHOE,1310903230,0,0,0,0,0.00%
Colorado,2018,G,ARAPAHOE,1310903402,0,0,0,0,0.00%
Colorado,2018,G,ARAPAHOE,1310903475,28,0,28,21,75.00%
Colorado,2018,G,ARAPAHOE,1310903501,1270,440,1710,902,52.75%
Colorado,2018,G,ARAPAHOE,1310903502,1237,503,1740,791,45.46%
Colorado,2018,G,ARAPAHOE,4283603348,0,0,0,0,0.00%
Colorado,2018,G,ARAPAHOE,4283603350,9,0,9,0,0.00%
Colorado,2018,G,ARAPAHOE,4293603358,38,22,60,32,53.33%
Colorado,2018,G,ARAPAHOE,4293603361,2,0,2,0,0.00%
Colorado,2018,G,ARAPAHOE,4295603357,2,0,2,0,0.00%
Colorado,2018,G,ARAPAHOE,4295603359,0,0,0,0,0.00%
Colorado,2018,G,ARAPAHOE,4295603362,1136,102,1238,881,71.16%
Colorado,2018,G,ARAPAHOE,4295603363,1156,122,1278,818,64.01%
Colorado,2018,G,ARAPAHOE,4295603364,1345,179,1524,969,63.58%
Colorado,2018,G,ARAPAHOE,4295603365,655,80,735,484,65.85%
Colorado,2018,G,ARAPAHOE,4295603366,891,88,979,730,74.57%
Colorado,2018,G,ARAPAHOE,6260303126,651,279,930,346,37.20%
Colorado,2018,G,ARAPAHOE,6260303127,123,30,153,82,53.59%
Colorado,2018,G,ARAPAHOE,6260303128,437,38,475,322,67.79%
Colorado,2018,G,ARAPAHOE,6260303143,765,171,936,569,60.79%
Colorado,2018,G,ARAPAHOE,6260303153,1312,348,1660,939,56.57%
Colorado,2018,G,ARAPAHOE,6260303161,747,115,862,576,66.82%
Colorado,2018,G,ARAPAHOE,6260303162,828,215,1043,570,54.65%
Colorado,2018,G,ARAPAHOE,6260303201,395,24,419,336,80.19%
Colorado,2018,G,ARAPAHOE,6260303202,369,12,381,305,80.05%
Colorado,2018,G,ARAPAHOE,6260303203,766,50,816,660,80.88%
Colorado,2018,G,ARAPAHOE,6260303204,1617,82,1699,1380,81.22%
Colorado,2018,G,ARAPAHOE,6260303229,1189,101,1290,1007,78.06%
Colorado,2018,G,ARAPAHOE,6260303231,1080,385,1465,761,51.95%
Colorado,2018,G,ARAPAHOE,6260303232,1476,322,1798,1130,62.85%
Colorado,2018,G,ARAPAHOE,6260303234,1254,241,1495,987,66.02%
Colorado,2018,G,ARAPAHOE,6260303249,828,58,886,732,82.62%
Colorado,2018,G,ARAPAHOE,6260303253,1592,138,1730,1278,73.87%
Colorado,2018,G,ARAPAHOE,6260303254,437,25,462,362,78.35%
Colorado,2018,G,ARAPAHOE,6260303256,0,0,0,0,0.00%
Colorado,2018,G,ARAPAHOE,6263803142,888,69,957,744,77.74%
Colorado,2018,G,ARAPAHOE,6263803144,791,43,834,649,77.82%
Colorado,2018,G,ARAPAHOE,6263803145,685,94,779,508,65.21%
Colorado,2018,G,ARAPAHOE,6263803146,809,34,843,709,84.10%
Colorado,2018,G,ARAPAHOE,6263803147,870,98,968,732,75.62%
Colorado,2018,G,ARAPAHOE,6263803148,583,30,613,507,82.71%
Colorado,2018,G,ARAPAHOE,6263803149,1226,51,1277,1077,84.34%
Colorado,2018,G,ARAPAHOE,6263803150,1226,228,1454,945,64.99%
Colorado,2018,G,ARAPAHOE,6263803151,834,250,1084,592,54.61%
Colorado,2018,G,ARAPAHOE,6263803152,842,90,932,696,74.68%
Colorado,2018,G,ARAPAHOE,6263803154,1081,165,1246,843,67.66%
Colorado,2018,G,ARAPAHOE,6263803155,1226,84,1310,1046,79.85%
Colorado,2018,G,ARAPAHOE,6263803156,471,17,488,414,84.84%
Colorado,2018,G,ARAPAHOE,6263803157,677,34,711,587,82.56%
Colorado,2018,G,ARAPAHOE,6263803158,863,115,978,681,69.63%
Colorado,2018,G,ARAPAHOE,6263803159,765,118,883,597,67.61%
Colorado,2018,G,ARAPAHOE,6263803160,877,137,1014,649,64.00%
Colorado,2018,G,ARAPAHOE,6263803163,799,92,891,618,69.36%
Colorado,2018,G,ARAPAHOE,6263803165,993,87,1080,821,76.02%
Colorado,2018,G,ARAPAHOE,6263803166,448,24,472,370,78.39%
Colorado,2018,G,ARAPAHOE,6263803167,909,93,1002,705,70.36%
Colorado,2018,G,ARAPAHOE,6263803168,916,52,968,815,84.19%
Colorado,2018,G,ARAPAHOE,6263803169,1039,66,1105,891,80.63%
Colorado,2018,G,ARAPAHOE,6263803170,1254,284,1538,894,58.13%
Colorado,2018,G,ARAPAHOE,6263803171,1461,116,1577,1263,80.09%
Colorado,2018,G,ARAPAHOE,6263803172,819,71,890,668,75.06%
Colorado,2018,G,ARAPAHOE,6263803173,860,47,907,696,76.74%
Colorado,2018,G,ARAPAHOE,6263803174,680,103,783,543,69.35%
Colorado,2018,G,ARAPAHOE,6263803175,932,133,1065,739,69.39%
Colorado,2018,G,ARAPAHOE,6263803176,1310,127,1437,1071,74.53%
Colorado,2018,G,ARAPAHOE,6264003255,1099,301,1400,817,58.36%
Colorado,2018,G,ARAPAHOE,6264003258,329,127,456,179,39.25%
Colorado,2018,G,ARAPAHOE,6264003323,38,3,41,28,68.29%
Colorado,2018,G,ARAPAHOE,6264003424,0,0,0,0,0.00%
Colorado,2018,G,ARAPAHOE,6264003453,555,30,585,459,78.46%
Colorado,2018,G,ARAPAHOE,6264003455,648,40,688,497,72.24%
Colorado,2018,G,ARAPAHOE,6264103401,1156,293,1449,778,53.69%
Colorado,2018,G,ARAPAHOE,6264103403,743,369,1112,516,46.40%
Colorado,2018,G,ARAPAHOE,6264103404,864,305,1169,527,45.08%
Colorado,2018,G,ARAPAHOE,6264103405,840,290,1130,513,45.40%
Colorado,2018,G,ARAPAHOE,6264103406,458,139,597,310,51.93%
Colorado,2018,G,ARAPAHOE,6264103407,1335,334,1669,990,59.32%
Colorado,2018,G,ARAPAHOE,6264103408,781,108,889,561,63.10%
Colorado,2018,G,ARAPAHOE,6264103409,1442,391,1833,974,53.14%
Colorado,2018,G,ARAPAHOE,6264103410,1162,172,1334,912,68.37%
Colorado,2018,G,ARAPAHOE,6264103411,1338,522,1860,861,46.29%
Colorado,2018,G,ARAPAHOE,6264103412,1373,447,1820,880,48.35%
Colorado,2018,G,ARAPAHOE,6264103413,1061,394,1455,696,47.84%
Colorado,2018,G,ARAPAHOE,6264103414,897,184,1081,658,60.87%
Colorado,2018,G,ARAPAHOE,6264103416,1523,255,1778,1082,60.85%
Colorado,2018,G,ARAPAHOE,6264103417,1023,191,1214,746,61.45%
Colorado,2018,G,ARAPAHOE,6264103418,908,74,982,686,69.86%
Colorado,2018,G,ARAPAHOE,6264103419,1029,104,1133,771,68.05%
Colorado,2018,G,ARAPAHOE,6264103423,1339,167,1506,1026,68.13%
Colorado,2018,G,ARAPAHOE,6264103425,1289,168,1457,988,67.81%
Colorado,2018,G,ARAPAHOE,6264103426,706,72,778,553,71.08%
Colorado,2018,G,ARAPAHOE,6264103442,749,69,818,654,79.95%
Colorado,2018,G,ARAPAHOE,6264103443,527,26,553,490,88.61%
Colorado,2018,G,ARAPAHOE,6270303245,491,27,518,413,79.73%
Colorado,2018,G,ARAPAHOE,6270303246,1019,141,1160,822,70.86%
Colorado,2018,G,ARAPAHOE,6270303247,1537,266,1803,1191,66.06%
Colorado,2018,G,ARAPAHOE,6270303248,653,133,786,495,62.98%
Colorado,2018,G,ARAPAHOE,6270303250,1011,74,1085,863,79.54%
Colorado,2018,G,ARAPAHOE,6270303251,1429,109,1538,1213,78.87%
Colorado,2018,G,ARAPAHOE,6270303252,1420,100,1520,1209,79.54%
Colorado,2018,G,ARAPAHOE,6273603335,1526,145,1671,1091,65.29%
Colorado,2018,G,ARAPAHOE,6273603336,1401,185,1586,1007,63.49%
Colorado,2018,G,ARAPAHOE,6273603337,1355,207,1562,941,60.24%
Colorado,2018,G,ARAPAHOE,6273603368,678,181,859,395,45.98%
Colorado,2018,G,ARAPAHOE,6273703218,867,153,1020,675,66.18%
Colorado,2018,G,ARAPAHOE,6273703220,892,67,959,754,78.62%
Colorado,2018,G,ARAPAHOE,6273703221,784,65,849,676,79.62%
Colorado,2018,G,ARAPAHOE,6273703222,886,51,937,773,82.50%
Colorado,2018,G,ARAPAHOE,6273703223,918,176,1094,727,66.45%
Colorado,2018,G,ARAPAHOE,6273703224,860,79,939,725,77.21%
Colorado,2018,G,ARAPAHOE,6273703225,970,69,1039,821,79.02%
Colorado,2018,G,ARAPAHOE,6273703226,688,64,752,600,79.79%
Colorado,2018,G,ARAPAHOE,6273703227,682,46,728,561,77.06%
Colorado,2018,G,ARAPAHOE,6273703228,756,56,812,624,76.85%
Colorado,2018,G,ARAPAHOE,6273703233,710,298,1008,476,47.22%
Colorado,2018,G,ARAPAHOE,6273703235,693,72,765,524,68.50%
Colorado,2018,G,ARAPAHOE,6273703236,662,71,733,517,70.53%
Colorado,2018,G,ARAPAHOE,6273703237,1183,98,1281,958,74.79%
Colorado,2018,G,ARAPAHOE,6273703238,823,102,925,642,69.41%
Colorado,2018,G,ARAPAHOE,6273703239,877,63,940,736,78.30%
Colorado,2018,G,ARAPAHOE,6273703240,1396,116,1512,1135,75.07%
Colorado,2018,G,ARAPAHOE,6273703241,1023,90,1113,857,77.00%
Colorado,2018,G,ARAPAHOE,6273703242,735,42,777,649,83.53%
Colorado,2018,G,ARAPAHOE,6273703243,1012,391,1403,592,42.20%
Colorado,2018,G,ARAPAHOE,6273703244,1005,142,1147,772,67.31%
Colorado,2018,G,ARAPAHOE,6273703257,1179,116,1295,906,69.96%
Colorado,2018,G,ARAPAHOE,6273703259,1791,594,2385,1107,46.42%
Colorado,2018,G,ARAPAHOE,6273703260,1460,288,1748,994,56.86%
Colorado,2018,G,ARAPAHOE,6273703261,1398,125,1523,1064,69.86%
Colorado,2018,G,ARAPAHOE,6273703262,1273,111,1384,1045,75.51%
Colorado,2018,G,ARAPAHOE,6273703263,1022,82,1104,826,74.82%
Colorado,2018,G,ARAPAHOE,6273703264,1213,102,1315,969,73.69%
Colorado,2018,G,ARAPAHOE,6273703274,1146,107,1253,900,71.83%
Colorado,2018,G,ARAPAHOE,6273703275,640,79,719,476,66.20%
Colorado,2018,G,ARAPAHOE,6273703276,308,55,363,227,62.53%
Colorado,2018,G,ARAPAHOE,6273703277,874,98,972,614,63.17%
Colorado,2018,G,ARAPAHOE,6273703278,522,44,566,394,69.61%
Colorado,2018,G,ARAPAHOE,6273703279,911,78,989,743,75.13%
Colorado,2018,G,ARAPAHOE,6273703280,1157,82,1239,884,71.35%
Colorado,2018,G,ARAPAHOE,6273703281,1155,110,1265,888,70.20%
Colorado,2018,G,ARAPAHOE,6273703282,1416,143,1559,1045,67.03%
Colorado,2018,G,ARAPAHOE,6273703283,878,79,957,672,70.22%
Colorado,2018,G,ARAPAHOE,6273703284,674,180,854,451,52.81%
Colorado,2018,G,ARAPAHOE,6273703285,724,78,802,600,74.81%
Colorado,2018,G,ARAPAHOE,6273703286,1563,341,1904,1130,59.35%
Colorado,2018,G,ARAPAHOE,6273703320,1580,199,1779,1098,61.72%
Colorado,2018,G,ARAPAHOE,6273703321,1271,120,1391,992,71.32%
Colorado,2018,G,ARAPAHOE,6273703322,1176,71,1247,925,74.18%
Colorado,2018,G,ARAPAHOE,6273703324,605,33,638,497,77.90%
Colorado,2018,G,ARAPAHOE,6273703325,1701,108,1809,1375,76.01%
Colorado,2018,G,ARAPAHOE,6273703328,302,21,323,244,75.54%
Colorado,2018,G,ARAPAHOE,6273703331,658,82,740,528,71.35%
Colorado,2018,G,ARAPAHOE,6273703332,1060,128,1188,783,65.91%
Colorado,2018,G,ARAPAHOE,6273703333,822,99,921,580,62.98%
Colorado,2018,G,ARAPAHOE,6273703334,1772,252,2024,1276,63.04%
Colorado,2018,G,ARAPAHOE,6273703338,956,131,1087,681,62.65%
Colorado,2018,G,ARAPAHOE,6273703339,1221,160,1381,872,63.14%
Colorado,2018,G,ARAPAHOE,6273703367,1279,78,1357,1022,75.31%
Colorado,2018,G,ARAPAHOE,6273703458,0,0,0,0,0.00%
Colorado,2018,G,ARAPAHOE,6273803164,785,78,863,613,71.03%
Colorado,2018,G,ARAPAHOE,6273803177,972,71,1043,761,72.96%
Colorado,2018,G,ARAPAHOE,6273803178,799,115,914,602,65.86%
Colorado,2018,G,ARAPAHOE,6273803179,686,57,743,527,70.93%
Colorado,2018,G,ARAPAHOE,6273803180,769,46,815,665,81.60%
Colorado,2018,G,ARAPAHOE,6273803181,710,79,789,567,71.86%
Colorado,2018,G,ARAPAHOE,6273803182,930,70,1000,780,78.00%
Colorado,2018,G,ARAPAHOE,6273803183,1317,171,1488,1060,71.24%
Colorado,2018,G,ARAPAHOE,6273803184,732,43,775,596,76.90%
Colorado,2018,G,ARAPAHOE,6273803185,900,106,1006,694,68.99%
Colorado,2018,G,ARAPAHOE,6273803186,930,55,985,791,80.30%
Colorado,2018,G,ARAPAHOE,6273803187,919,63,982,766,78.00%
Colorado,2018,G,ARAPAHOE,6273803188,650,39,689,543,78.81%
Colorado,2018,G,ARAPAHOE,6273803189,1069,81,1150,876,76.17%
Colorado,2018,G,ARAPAHOE,6273803190,1210,165,1375,933,67.85%
Colorado,2018,G,ARAPAHOE,6273803191,1148,48,1196,990,82.78%
Colorado,2018,G,ARAPAHOE,6273803192,1038,68,1106,877,79.29%
Colorado,2018,G,ARAPAHOE,6273803193,875,77,952,717,75.32%
Colorado,2018,G,ARAPAHOE,6273803194,1145,97,1242,947,76.25%
Colorado,2018,G,ARAPAHOE,6273803195,1011,37,1048,876,83.59%
Colorado,2018,G,ARAPAHOE,6273803196,635,40,675,541,80.15%
Colorado,2018,G,ARAPAHOE,6273803197,712,39,751,602,80.16%
Colorado,2018,G,ARAPAHOE,6273803205,663,57,720,536,74.44%
Colorado,2018,G,ARAPAHOE,6273803206,788,37,825,671,81.33%
Colorado,2018,G,ARAPAHOE,6273803207,1128,72,1200,920,76.67%
Colorado,2018,G,ARAPAHOE,6273803208,1120,94,1214,902,74.30%
Colorado,2018,G,ARAPAHOE,6273803209,993,60,1053,862,81.86%
Colorado,2018,G,ARAPAHOE,6273803210,1488,132,1620,1221,75.37%
Colorado,2018,G,ARAPAHOE,6273803211,889,74,963,683,70.92%
Colorado,2018,G,ARAPAHOE,6273803212,1249,164,1413,977,69.14%
Colorado,2018,G,ARAPAHOE,6273803213,1034,109,1143,815,71.30%
Colorado,2018,G,ARAPAHOE,6273803214,861,48,909,701,77.12%
Colorado,2018,G,ARAPAHOE,6273803215,694,35,729,593,81.34%
Colorado,2018,G,ARAPAHOE,6273803216,908,48,956,764,79.92%
Colorado,2018,G,ARAPAHOE,6273803217,839,46,885,722,81.58%
Colorado,2018,G,ARAPAHOE,6273803219,1160,61,1221,1006,82.39%
Colorado,2018,G,ARAPAHOE,6274003457,1,2,3,0,0.00%
Colorado,2018,G,ARAPAHOE,6283603318,924,128,1052,645,61.31%
Colorado,2018,G,ARAPAHOE,6283603340,1824,123,1947,1411,72.47%
Colorado,2018,G,ARAPAHOE,6283603341,1609,198,1807,1211,67.02%
Colorado,2018,G,ARAPAHOE,6283603342,1694,236,1930,1114,57.72%
Colorado,2018,G,ARAPAHOE,6283603343,1110,123,1233,823,66.75%
Colorado,2018,G,ARAPAHOE,6283603344,1562,157,1719,1162,67.60%
Colorado,2018,G,ARAPAHOE,6283603349,0,0,0,0,0.00%
Colorado,2018,G,ARAPAHOE,6283603351,1700,196,1896,1250,65.93%
Colorado,2018,G,ARAPAHOE,6283603369,1015,93,1108,677,61.10%
Colorado,2018,G,ARAPAHOE,6283603370,1440,174,1614,1027,63.63%
Colorado,2018,G,ARAPAHOE,6283603371,910,114,1024,644,62.89%
Colorado,2018,G,ARAPAHOE,6283603372,1599,213,1812,1138,62.80%
Colorado,2018,G,ARAPAHOE,6283603561,0,0,0,0,0.00%
Colorado,2018,G,ARAPAHOE,6284003265,1003,181,1184,598,50.51%
Colorado,2018,G,ARAPAHOE,6284003266,1032,167,1199,713,59.47%
Colorado,2018,G,ARAPAHOE,6284003267,1032,149,1181,768,65.03%
Colorado,2018,G,ARAPAHOE,6284003268,822,136,958,633,66.08%
Colorado,2018,G,ARAPAHOE,6284003269,1007,175,1182,660,55.84%
Colorado,2018,G,ARAPAHOE,6284003270,878,155,1033,578,55.95%
Colorado,2018,G,ARAPAHOE,6284003271,735,99,834,527,63.19%
Colorado,2018,G,ARAPAHOE,6284003272,835,56,891,625,70.15%
Colorado,2018,G,ARAPAHOE,6284003273,872,91,963,622,64.59%
Colorado,2018,G,ARAPAHOE,6284003302,1206,114,1320,904,68.48%
Colorado,2018,G,ARAPAHOE,6284003303,880,83,963,672,69.78%
Colorado,2018,G,ARAPAHOE,6284003304,836,128,964,575,59.65%
Colorado,2018,G,ARAPAHOE,6284003305,1233,190,1423,895,62.90%
Colorado,2018,G,ARAPAHOE,6284003306,825,99,924,603,65.26%
Colorado,2018,G,ARAPAHOE,6284003307,706,323,1029,368,35.76%
Colorado,2018,G,ARAPAHOE,6284003308,1109,173,1282,805,62.79%
Colorado,2018,G,ARAPAHOE,6284003309,1213,188,1401,847,60.46%
Colorado,2018,G,ARAPAHOE,6284003310,1706,192,1898,1170,61.64%
Colorado,2018,G,ARAPAHOE,6284003311,1690,171,1861,1196,64.27%
Colorado,2018,G,ARAPAHOE,6284003312,1633,254,1887,1108,58.72%
Colorado,2018,G,ARAPAHOE,6284003313,1057,113,1170,725,61.97%
Colorado,2018,G,ARAPAHOE,6284003314,738,81,819,548,66.91%
Colorado,2018,G,ARAPAHOE,6284003315,1426,189,1615,988,61.18%
Colorado,2018,G,ARAPAHOE,6284003316,710,72,782,499,63.81%
Colorado,2018,G,ARAPAHOE,6284003317,1025,140,1165,695,59.66%
Colorado,2018,G,ARAPAHOE,6284003319,1694,268,1962,1113,56.73%
Colorado,2018,G,ARAPAHOE,6284003446,773,99,872,619,70.99%
Colorado,2018,G,ARAPAHOE,6284003447,923,176,1099,613,55.78%
Colorado,2018,G,ARAPAHOE,6284003448,1563,346,1909,1179,61.76%
Colorado,2018,G,ARAPAHOE,6284003449,699,108,807,540,66.91%
Colorado,2018,G,ARAPAHOE,6284003450,1203,288,1491,768,51.51%
Colorado,2018,G,ARAPAHOE,6284003451,1160,166,1326,822,61.99%
Colorado,2018,G,ARAPAHOE,6284003452,829,88,917,622,67.83%
Colorado,2018,G,ARAPAHOE,6284003454,1010,122,1132,758,66.96%
Colorado,2018,G,ARAPAHOE,6284003456,1118,139,1257,823,65.47%
Colorado,2018,G,ARAPAHOE,6284003459,856,126,982,569,57.94%
Colorado,2018,G,ARAPAHOE,6284003460,1027,187,1214,714,58.81%
Colorado,2018,G,ARAPAHOE,6284003461,1213,154,1367,832,60.86%
Colorado,2018,G,ARAPAHOE,6284003462,1135,146,1281,850,66.35%
Colorado,2018,G,ARAPAHOE,6284003463,1384,154,1538,1008,65.54%
Colorado,2018,G,ARAPAHOE,6284003464,879,150,1029,609,59.18%
Colorado,2018,G,ARAPAHOE,6284003472,1163,404,1567,661,42.18%
Colorado,2018,G,ARAPAHOE,6284003473,1537,362,1899,985,51.87%
Colorado,2018,G,ARAPAHOE,6284103301,634,74,708,426,60.17%
Colorado,2018,G,ARAPAHOE,6284103420,1666,253,1919,1147,59.77%
Colorado,2018,G,ARAPAHOE,6284103421,523,43,566,427,75.44%
Colorado,2018,G,ARAPAHOE,6284103422,651,90,741,476,64.24%
Colorado,2018,G,ARAPAHOE,6284103427,1408,201,1609,1095,68.05%
Colorado,2018,G,ARAPAHOE,6284103428,1002,172,1174,737,62.78%
Colorado,2018,G,ARAPAHOE,6284103429,886,303,1189,589,49.54%
Colorado,2018,G,ARAPAHOE,6284103430,1022,239,1261,740,58.68%
Colorado,2018,G,ARAPAHOE,6284103431,587,60,647,435,67.23%
Colorado,2018,G,ARAPAHOE,6284103432,1132,264,1396,761,54.51%
Colorado,2018,G,ARAPAHOE,6284103433,910,190,1100,625,56.82%
Colorado,2018,G,ARAPAHOE,6284103437,1349,159,1508,938,62.20%
Colorado,2018,G,ARAPAHOE,6284103438,961,174,1135,715,63.00%
Colorado,2018,G,ARAPAHOE,6284103439,930,94,1024,695,67.87%
Colorado,2018,G,ARAPAHOE,6284103440,815,71,886,746,84.20%
Colorado,2018,G,ARAPAHOE,6284103441,833,43,876,758,86.53%
Colorado,2018,G,ARAPAHOE,6284103444,602,71,673,445,66.12%
Colorado,2018,G,ARAPAHOE,6284103445,640,104,744,459,61.69%
Colorado,2018,G,ARAPAHOE,6284103465,637,67,704,456,64.77%
Colorado,2018,G,ARAPAHOE,6284103466,878,124,1002,627,62.57%
Colorado,2018,G,ARAPAHOE,6284103467,862,118,980,624,63.67%
Colorado,2018,G,ARAPAHOE,6284103468,832,119,951,584,61.41%
Colorado,2018,G,ARAPAHOE,6284103469,723,190,913,432,47.32%
Colorado,2018,G,ARAPAHOE,6284103470,1164,219,1383,690,49.89%
Colorado,2018,G,ARAPAHOE,6284103471,1007,129,1136,665,58.54%
Colorado,2018,G,ARAPAHOE,6284203434,1060,216,1276,737,57.76%
Colorado,2018,G,ARAPAHOE,6284203435,1308,273,1581,831,52.56%
Colorado,2018,G,ARAPAHOE,6284203436,1344,360,1704,803,47.12%
Colorado,2018,G,ARAPAHOE,6285603352,1337,275,1612,899,55.77%
Colorado,2018,G,ARAPAHOE,6285603373,1304,98,1402,1012,72.18%
Colorado,2018,G,ARAPAHOE,6285603378,1288,151,1439,957,66.50%
Colorado,2018,G,ARAPAHOE,6293603345,439,26,465,337,72.47%
Colorado,2018,G,ARAPAHOE,6293603346,1309,162,1471,980,66.62%
Colorado,2018,G,ARAPAHOE,6293603347,782,123,905,537,59.34%
Colorado,2018,G,ARAPAHOE,6293603360,443,107,550,199,36.18%
Colorado,2018,G,ARAPAHOE,6293603374,1658,247,1905,1177,61.78%
Colorado,2018,G,ARAPAHOE,6293603381,1408,112,1520,1093,71.91%
Colorado,2018,G,ARAPAHOE,6293603474,698,120,818,425,51.96%
Colorado,2018,G,ARAPAHOE,6293603537,1097,196,1293,682,52.75%
Colorado,2018,G,ARAPAHOE,6293603538,1099,160,1259,758,60.21%
Colorado,2018,G,ARAPAHOE,6293603539,1046,272,1318,686,52.05%
Colorado,2018,G,ARAPAHOE,6293603540,677,76,753,446,59.23%
Colorado,2018,G,ARAPAHOE,6293603541,700,108,808,464,57.43%
Colorado,2018,G,ARAPAHOE,6293603542,686,416,1102,315,28.58%
Colorado,2018,G,ARAPAHOE,6293603543,898,139,1037,641,61.81%
Colorado,2018,G,ARAPAHOE,6293603544,1075,448,1523,577,37.89%
Colorado,2018,G,ARAPAHOE,6293603545,377,146,523,202,38.62%
Colorado,2018,G,ARAPAHOE,6293603546,1022,164,1186,679,57.25%
Colorado,2018,G,ARAPAHOE,6293603547,1002,104,1106,648,58.59%
Colorado,2018,G,ARAPAHOE,6293603548,443,224,667,203,30.43%
Colorado,2018,G,ARAPAHOE,6293603549,532,133,665,273,41.05%
Colorado,2018,G,ARAPAHOE,6293603550,86,12,98,52,53.06%
Colorado,2018,G,ARAPAHOE,6293603551,732,316,1048,400,38.17%
Colorado,2018,G,ARAPAHOE,6293603552,909,281,1190,510,42.86%
Colorado,2018,G,ARAPAHOE,6293603553,1273,278,1551,797,51.39%
Colorado,2018,G,ARAPAHOE,6293603554,1037,161,1198,737,61.52%
Colorado,2018,G,ARAPAHOE,6293603555,887,167,1054,565,53.61%
Colorado,2018,G,ARAPAHOE,6293603556,1196,154,1350,821,60.81%
Colorado,2018,G,ARAPAHOE,6293603557,1572,316,1888,1086,57.52%
Colorado,2018,G,ARAPAHOE,6293603558,913,155,1068,630,58.99%
Colorado,2018,G,ARAPAHOE,6293603559,874,106,980,576,58.78%
Colorado,2018,G,ARAPAHOE,6293603560,451,91,542,292,53.87%
Colorado,2018,G,ARAPAHOE,6294203503,1651,438,2089,957,45.81%
Colorado,2018,G,ARAPAHOE,6294203504,939,142,1081,551,50.97%
Colorado,2018,G,ARAPAHOE,6294203505,888,333,1221,492,40.29%
Colorado,2018,G,ARAPAHOE,6294203506,1401,478,1879,666,35.44%
Colorado,2018,G,ARAPAHOE,6294203507,842,137,979,508,51.89%
Colorado,2018,G,ARAPAHOE,6294203508,692,102,794,395,49.75%
Colorado,2018,G,ARAPAHOE,6294203509,637,68,705,435,61.70%
Colorado,2018,G,ARAPAHOE,6294203510,677,61,738,534,72.36%
Colorado,2018,G,ARAPAHOE,6294203511,945,409,1354,518,38.26%
Colorado,2018,G,ARAPAHOE,6294203512,985,268,1253,595,47.49%
Colorado,2018,G,ARAPAHOE,6294203513,909,281,1190,581,48.82%
Colorado,2018,G,ARAPAHOE,6294203514,689,292,981,408,41.59%
Colorado,2018,G,ARAPAHOE,6294203515,937,87,1024,659,64.36%
Colorado,2018,G,ARAPAHOE,6294203516,696,122,818,469,57.33%
Colorado,2018,G,ARAPAHOE,6294203517,712,123,835,469,56.17%
Colorado,2018,G,ARAPAHOE,6294203518,686,153,839,434,51.73%
Colorado,2018,G,ARAPAHOE,6294203519,812,230,1042,473,45.39%
Colorado,2018,G,ARAPAHOE,6294203520,914,125,1039,629,60.54%
Colorado,2018,G,ARAPAHOE,6294203521,787,137,924,502,54.33%
Colorado,2018,G,ARAPAHOE,6294203522,959,131,1090,642,58.90%
Colorado,2018,G,ARAPAHOE,6294203523,1280,175,1455,878,60.34%
Colorado,2018,G,ARAPAHOE,6294203524,854,198,1052,520,49.43%
Colorado,2018,G,ARAPAHOE,6294203525,897,172,1069,524,49.02%
Colorado,2018,G,ARAPAHOE,6294203526,812,139,951,484,50.89%
Colorado,2018,G,ARAPAHOE,6294203527,1005,296,1301,573,44.04%
Colorado,2018,G,ARAPAHOE,6294203528,483,136,619,251,40.55%
Colorado,2018,G,ARAPAHOE,6294203529,414,157,571,204,35.73%
Colorado,2018,G,ARAPAHOE,6294203530,946,280,1226,459,37.44%
Colorado,2018,G,ARAPAHOE,6294203531,803,117,920,498,54.13%
Colorado,2018,G,ARAPAHOE,6294203532,935,358,1293,595,46.02%
Colorado,2018,G,ARAPAHOE,6294203533,1290,388,1678,800,47.68%
Colorado,2018,G,ARAPAHOE,6294203534,813,544,1357,482,35.52%
Colorado,2018,G,ARAPAHOE,6294203535,812,116,928,605,65.19%
Colorado,2018,G,ARAPAHOE,6294203536,655,311,966,361,37.37%
Colorado,2018,G,ARAPAHOE,6295603326,1380,108,1488,1264,84.95%
Colorado,2018,G,ARAPAHOE,6295603327,1081,129,1210,781,64.55%
Colorado,2018,G,ARAPAHOE,6295603329,1208,276,1484,833,56.13%
Colorado,2018,G,ARAPAHOE,6295603330,1765,260,2025,1270,62.72%
Colorado,2018,G,ARAPAHOE,6295603353,1057,134,1191,828,69.52%
Colorado,2018,G,ARAPAHOE,6295603354,1551,172,1723,1247,72.37%
Colorado,2018,G,ARAPAHOE,6295603355,2158,150,2308,1612,69.84%
Colorado,2018,G,ARAPAHOE,6295603356,839,30,869,672,77.33%
Colorado,2018,G,ARAPAHOE,6295603375,988,226,1214,754,62.11%
Colorado,2018,G,ARAPAHOE,6295603376,1336,98,1434,1174,81.87%
Colorado,2018,G,ARAPAHOE,6295603377,1628,113,1741,1305,74.96%
Colorado,2018,G,ARAPAHOE,6295603379,923,107,1030,735,71.36%
Colorado,2018,G,ARAPAHOE,6295603380,752,67,819,601,73.38%
Colorado,2018,G,ARCHULETA,3065904001,1119,183,1302,818,62.83%
Colorado,2018,G,ARCHULETA,3065904002,956,170,1126,740,65.72%
Colorado,2018,G,ARCHULETA,3065904003,754,141,895,605,67.60%
Colorado,2018,G,ARCHULETA,3065904004,399,75,474,290,61.18%
Colorado,2018,G,ARCHULETA,3065904005,1024,237,1261,669,53.05%
Colorado,2018,G,ARCHULETA,3065904006,1631,337,1968,1315,66.82%
Colorado,2018,G,ARCHULETA,3065904007,1591,483,2074,1224,59.02%
Colorado,2018,G,ARCHULETA,3065904008,1725,347,2072,1296,62.55%
Colorado,2018,G,BACA,4356405001,310,16,326,234,71.78%
Colorado,2018,G,BACA,4356405002,338,40,378,258,68.25%
Colorado,2018,G,BACA,4356405003,186,18,204,142,69.61%
Colorado,2018,G,BACA,4356405004,412,54,466,303,65.02%
Colorado,2018,G,BACA,4356405005,138,14,152,113,74.34%
Colorado,2018,G,BACA,4356405006,185,17,202,143,70.79%
Colorado,2018,G,BACA,4356405007,470,61,531,354,66.67%
Colorado,2018,G,BACA,4356405008,448,43,491,341,69.45%
Colorado,2018,G,BACA,4356405009,95,6,101,70,69.31%
Colorado,2018,G,BENT,4356406001,431,119,550,331,60.18%
Colorado,2018,G,BENT,4356406002,534,67,601,406,67.55%
Colorado,2018,G,BENT,4356406003,593,164,757,437,57.73%
Colorado,2018,G,BENT,4356406004,485,122,607,330,54.37%
Colorado,2018,G,BENT,4356406005,525,92,617,417,67.59%
Colorado,2018,G,BOULDER,2161307900,491,49,540,426,78.89%
Colorado,2018,G,BOULDER,2161307901,663,72,735,534,72.65%
Colorado,2018,G,BOULDER,2161307902,282,39,321,231,71.96%
Colorado,2018,G,BOULDER,2163307100,1377,143,1520,1149,75.59%
Colorado,2018,G,BOULDER,2163307101,1266,124,1390,1085,78.06%
Colorado,2018,G,BOULDER,2163307102,1081,426,1507,734,48.71%
Colorado,2018,G,BOULDER,2163307103,1147,71,1218,968,79.47%
Colorado,2018,G,BOULDER,2163307104,1112,82,1194,944,79.06%
Colorado,2018,G,BOULDER,2163307105,482,88,570,384,67.37%
Colorado,2018,G,BOULDER,2163307106,1034,76,1110,874,78.74%
Colorado,2018,G,BOULDER,2163307107,807,88,895,646,72.18%
Colorado,2018,G,BOULDER,2171207200,635,50,685,541,78.98%
Colorado,2018,G,BOULDER,2171207201,658,54,712,575,80.76%
Colorado,2018,G,BOULDER,2171207202,1116,134,1250,926,74.08%
Colorado,2018,G,BOULDER,2171207203,1005,37,1042,892,85.60%
Colorado,2018,G,BOULDER,2171207204,963,104,1067,831,77.88%
Colorado,2018,G,BOULDER,2171207205,965,57,1022,831,81.31%
Colorado,2018,G,BOULDER,2171207206,549,30,579,502,86.70%
Colorado,2018,G,BOULDER,2171207207,954,71,1025,845,82.44%
Colorado,2018,G,BOULDER,2171207208,1065,79,1144,951,83.13%
Colorado,2018,G,BOULDER,2171207209,613,26,639,553,86.54%
Colorado,2018,G,BOULDER,2171207210,917,66,983,814,82.81%
Colorado,2018,G,BOULDER,2171207211,1082,105,1187,903,76.07%
Colorado,2018,G,BOULDER,2171207212,1370,143,1513,1120,74.03%
Colorado,2018,G,BOULDER,2171207213,1269,112,1381,1101,79.72%
Colorado,2018,G,BOULDER,2171207214,1252,109,1361,1093,80.31%
Colorado,2018,G,BOULDER,2171207215,887,66,953,763,80.06%
Colorado,2018,G,BOULDER,2171207300,1498,178,1676,1247,74.40%
Colorado,2018,G,BOULDER,2171207301,1836,146,1982,1376,69.42%
Colorado,2018,G,BOULDER,2171207302,1533,109,1642,1307,79.60%
Colorado,2018,G,BOULDER,2171207303,940,139,1079,746,69.14%
Colorado,2018,G,BOULDER,2171207304,891,57,948,784,82.70%
Colorado,2018,G,BOULDER,2171207305,1106,146,1252,897,71.65%
Colorado,2018,G,BOULDER,2171207306,1200,131,1331,982,73.78%
Colorado,2018,G,BOULDER,2171207307,912,243,1155,600,51.95%
Colorado,2018,G,BOULDER,2171207308,996,119,1115,831,74.53%
Colorado,2018,G,BOULDER,2171207309,1113,115,1228,941,76.63%
Colorado,2018,G,BOULDER,2171207310,1313,125,1438,1099,76.43%
Colorado,2018,G,BOULDER,2171207311,839,101,940,692,73.62%
Colorado,2018,G,BOULDER,2171207312,967,72,1039,854,82.19%
Colorado,2018,G,BOULDER,2171207313,1293,87,1380,1122,81.30%
Colorado,2018,G,BOULDER,2171207314,1395,66,1461,1228,84.05%
Colorado,2018,G,BOULDER,2171207315,819,91,910,715,78.57%
Colorado,2018,G,BOULDER,2171207316,1205,77,1282,1042,81.28%
Colorado,2018,G,BOULDER,2171207407,457,23,480,381,79.38%
Colorado,2018,G,BOULDER,2173307400,126,8,134,115,85.82%
Colorado,2018,G,BOULDER,2173307408,1220,118,1338,1052,78.62%
Colorado,2018,G,BOULDER,2173307409,1607,143,1750,1322,75.54%
Colorado,2018,G,BOULDER,2173307410,1128,60,1188,975,82.07%
Colorado,2018,G,BOULDER,2173307411,1211,42,1253,1070,85.40%
Colorado,2018,G,BOULDER,2173307412,1730,110,1840,1453,78.97%
Colorado,2018,G,BOULDER,2173307413,1265,118,1383,1050,75.92%
Colorado,2018,G,BOULDER,2181007500,914,105,1019,770,75.56%
Colorado,2018,G,BOULDER,2181007501,907,54,961,802,83.45%
Colorado,2018,G,BOULDER,2181007502,1029,70,1099,891,81.07%
Colorado,2018,G,BOULDER,2181007503,1464,97,1561,1331,85.27%
Colorado,2018,G,BOULDER,2181007504,745,40,785,659,83.95%
Colorado,2018,G,BOULDER,2181007800,868,82,950,748,78.74%
Colorado,2018,G,BOULDER,2181007801,797,137,934,679,72.70%
Colorado,2018,G,BOULDER,2181007802,997,273,1270,808,63.62%
Colorado,2018,G,BOULDER,2181007803,974,207,1181,800,67.74%
Colorado,2018,G,BOULDER,2181007804,1289,106,1395,1125,80.65%
Colorado,2018,G,BOULDER,2181007805,483,28,511,427,83.56%
Colorado,2018,G,BOULDER,2181007806,1198,250,1448,1001,69.13%
Colorado,2018,G,BOULDER,2181007807,1158,99,1257,1004,79.87%
Colorado,2018,G,BOULDER,2181007808,1933,264,2197,1569,71.42%
Colorado,2018,G,BOULDER,2181007809,1027,89,1116,919,82.35%
Colorado,2018,G,BOULDER,2181007810,1040,65,1105,882,79.82%
Colorado,2018,G,BOULDER,2181007811,1278,89,1367,1134,82.96%
Colorado,2018,G,BOULDER,2181007812,1141,94,1235,970,78.54%
Colorado,2018,G,BOULDER,2181007813,944,111,1055,727,68.91%
Colorado,2018,G,BOULDER,2181007814,1081,132,1213,925,76.26%
Colorado,2018,G,BOULDER,2181007815,817,215,1032,670,64.92%
Colorado,2018,G,BOULDER,2181007816,1119,209,1328,948,71.39%
Colorado,2018,G,BOULDER,2181007817,810,51,861,723,83.97%
Colorado,2018,G,BOULDER,2181007818,1035,133,1168,907,77.65%
Colorado,2018,G,BOULDER,2181007819,878,137,1015,752,74.09%
Colorado,2018,G,BOULDER,2181007820,661,77,738,597,80.89%
Colorado,2018,G,BOULDER,2181007821,1079,197,1276,900,70.53%
Colorado,2018,G,BOULDER,2181007822,976,247,1223,754,61.65%
Colorado,2018,G,BOULDER,2181007823,1884,462,2346,1384,58.99%
Colorado,2018,G,BOULDER,2181007824,1111,153,1264,920,72.78%
Colorado,2018,G,BOULDER,2181007825,617,79,696,549,78.88%
Colorado,2018,G,BOULDER,2181007826,834,121,955,715,74.87%
Colorado,2018,G,BOULDER,2181007827,890,218,1108,735,66.34%
Colorado,2018,G,BOULDER,2181007828,668,209,877,550,62.71%
Colorado,2018,G,BOULDER,2181007829,720,276,996,567,56.93%
Colorado,2018,G,BOULDER,2181007830,712,337,1049,543,51.76%
Colorado,2018,G,BOULDER,2181007831,777,403,1180,610,51.69%
Colorado,2018,G,BOULDER,2181007832,322,103,425,248,58.35%
Colorado,2018,G,BOULDER,2181007833,674,461,1135,503,44.32%
Colorado,2018,G,BOULDER,2181007834,819,979,1798,585,32.54%
Colorado,2018,G,BOULDER,2181007835,453,369,822,334,40.63%
Colorado,2018,G,BOULDER,2181007836,486,150,636,413,64.94%
Colorado,2018,G,BOULDER,2181007837,924,327,1251,664,53.08%
Colorado,2018,G,BOULDER,2181007838,450,211,661,336,50.83%
Colorado,2018,G,BOULDER,2181007839,612,60,672,543,80.80%
Colorado,2018,G,BOULDER,2181007840,611,113,724,525,72.51%
Colorado,2018,G,BOULDER,2181007841,558,102,660,495,75.00%
Colorado,2018,G,BOULDER,2181007842,1111,110,1221,961,78.71%
Colorado,2018,G,BOULDER,2181007843,1272,95,1367,1125,82.30%
Colorado,2018,G,BOULDER,2181007844,738,116,854,588,68.85%
Colorado,2018,G,BOULDER,2181007845,849,222,1071,708,66.11%
Colorado,2018,G,BOULDER,2181007846,1196,407,1603,838,52.28%
Colorado,2018,G,BOULDER,2181007847,789,371,1160,532,45.86%
Colorado,2018,G,BOULDER,2181007848,649,154,803,531,66.13%
Colorado,2018,G,BOULDER,2181007849,653,843,1496,449,30.01%
Colorado,2018,G,BOULDER,2181007850,673,49,722,587,81.30%
Colorado,2018,G,BOULDER,2181007851,995,147,1142,846,74.08%
Colorado,2018,G,BOULDER,2181007852,1096,182,1278,909,71.13%
Colorado,2018,G,BOULDER,2181007853,841,222,1063,672,63.22%
Colorado,2018,G,BOULDER,2181107505,848,93,941,734,78.00%
Colorado,2018,G,BOULDER,2181107506,595,52,647,502,77.59%
Colorado,2018,G,BOULDER,2181107507,1180,77,1257,1014,80.67%
Colorado,2018,G,BOULDER,2181107508,757,52,809,676,83.56%
Colorado,2018,G,BOULDER,2181107700,938,73,1011,816,80.71%
Colorado,2018,G,BOULDER,2181107701,577,31,608,507,83.39%
Colorado,2018,G,BOULDER,2181107702,361,26,387,316,81.65%
Colorado,2018,G,BOULDER,2181107703,472,23,495,407,82.22%
Colorado,2018,G,BOULDER,2181107704,349,34,383,297,77.55%
Colorado,2018,G,BOULDER,2181107705,663,33,696,550,79.02%
Colorado,2018,G,BOULDER,2181107912,1153,79,1232,1013,82.22%
Colorado,2018,G,BOULDER,2181107913,675,31,706,589,83.43%
Colorado,2018,G,BOULDER,2181107916,466,50,516,389,75.39%
Colorado,2018,G,BOULDER,2181107917,1353,137,1490,1172,78.66%
Colorado,2018,G,BOULDER,2181107918,1170,94,1264,1010,79.91%
Colorado,2018,G,BOULDER,2181207401,718,37,755,612,81.06%
Colorado,2018,G,BOULDER,2181207402,640,22,662,561,84.74%
Colorado,2018,G,BOULDER,2181207403,946,65,1011,819,81.01%
Colorado,2018,G,BOULDER,2181207404,961,81,1042,847,81.29%
Colorado,2018,G,BOULDER,2181207405,498,24,522,419,80.27%
Colorado,2018,G,BOULDER,2181207406,717,28,745,605,81.21%
Colorado,2018,G,BOULDER,2181307854,992,216,1208,761,63.00%
Colorado,2018,G,BOULDER,2181307855,818,219,1037,680,65.57%
Colorado,2018,G,BOULDER,2181307856,636,61,697,544,78.05%
Colorado,2018,G,BOULDER,2181307857,849,103,952,739,77.63%
Colorado,2018,G,BOULDER,2181307858,943,93,1036,839,80.98%
Colorado,2018,G,BOULDER,2181307859,821,61,882,743,84.24%
Colorado,2018,G,BOULDER,2181307860,646,50,696,563,80.89%
Colorado,2018,G,BOULDER,2181307861,609,60,669,544,81.32%
Colorado,2018,G,BOULDER,2181307862,646,61,707,580,82.04%
Colorado,2018,G,BOULDER,2181307863,792,62,854,704,82.44%
Colorado,2018,G,BOULDER,2181307864,647,53,700,575,82.14%
Colorado,2018,G,BOULDER,2181307865,647,161,808,528,65.35%
Colorado,2018,G,BOULDER,2181307866,894,126,1020,751,73.63%
Colorado,2018,G,BOULDER,2181307867,830,151,981,687,70.03%
Colorado,2018,G,BOULDER,2181307868,884,41,925,799,86.38%
Colorado,2018,G,BOULDER,2181307869,577,99,676,517,76.48%
Colorado,2018,G,BOULDER,2181307870,726,121,847,527,62.22%
Colorado,2018,G,BOULDER,2181307871,791,167,958,650,67.85%
Colorado,2018,G,BOULDER,2181307872,721,455,1176,507,43.11%
Colorado,2018,G,BOULDER,2181307873,462,40,502,401,79.88%
Colorado,2018,G,BOULDER,2181307874,1034,147,1181,850,71.97%
Colorado,2018,G,BOULDER,2181307875,558,284,842,355,42.16%
Colorado,2018,G,BOULDER,2181307876,669,562,1231,418,33.96%
Colorado,2018,G,BOULDER,2181307877,675,177,852,588,69.01%
Colorado,2018,G,BOULDER,2181307878,676,280,956,548,57.32%
Colorado,2018,G,BOULDER,2181307879,697,334,1031,549,53.25%
Colorado,2018,G,BOULDER,2181307880,839,703,1542,577,37.42%
Colorado,2018,G,BOULDER,2181307881,665,173,838,538,64.20%
Colorado,2018,G,BOULDER,2181307882,656,77,733,561,76.53%
Colorado,2018,G,BOULDER,2181307883,811,135,946,713,75.37%
Colorado,2018,G,BOULDER,2181307884,897,318,1215,725,59.67%
Colorado,2018,G,BOULDER,2181307885,617,75,692,549,79.34%
Colorado,2018,G,BOULDER,2181307886,802,86,888,719,80.97%
Colorado,2018,G,BOULDER,2181307887,979,84,1063,839,78.93%
Colorado,2018,G,BOULDER,2181307888,827,51,878,755,85.99%
Colorado,2018,G,BOULDER,2181307903,1845,280,2125,1563,73.55%
Colorado,2018,G,BOULDER,2181307904,520,45,565,429,75.93%
Colorado,2018,G,BOULDER,2181307905,286,29,315,246,78.10%
Colorado,2018,G,BOULDER,2181307906,552,31,583,472,80.96%
Colorado,2018,G,BOULDER,2181307908,995,81,1076,839,77.97%
Colorado,2018,G,BOULDER,2181307909,561,50,611,489,80.03%
Colorado,2018,G,BOULDER,2181307910,769,67,836,643,76.91%
Colorado,2018,G,BOULDER,2181307911,944,73,1017,821,80.73%
Colorado,2018,G,BOULDER,2181307914,591,39,630,516,81.90%
Colorado,2018,G,BOULDER,2181307915,393,51,444,314,70.72%
Colorado,2018,G,BOULDER,4171107616,1119,71,1190,926,77.82%
Colorado,2018,G,BOULDER,4171107617,2097,197,2294,1674,72.97%
Colorado,2018,G,BOULDER,4171107618,1896,107,2003,1589,79.33%
Colorado,2018,G,BOULDER,4171107619,1557,332,1889,1109,58.71%
Colorado,2018,G,BOULDER,4171107620,1400,234,1634,1152,70.50%
Colorado,2018,G,BOULDER,4171107621,1067,105,1172,881,75.17%
Colorado,2018,G,BOULDER,4171107622,767,110,877,561,63.97%
Colorado,2018,G,BOULDER,4171107623,1193,223,1416,887,62.64%
Colorado,2018,G,BOULDER,4171107624,859,135,994,721,72.54%
Colorado,2018,G,BOULDER,4171107625,835,75,910,717,78.79%
Colorado,2018,G,BOULDER,4171107626,1098,122,1220,882,72.30%
Colorado,2018,G,BOULDER,4171107627,749,162,911,498,54.67%
Colorado,2018,G,BOULDER,4171107628,959,90,1049,808,77.03%
Colorado,2018,G,BOULDER,4171107629,623,67,690,498,72.17%
Colorado,2018,G,BOULDER,4171107630,917,142,1059,665,62.80%
Colorado,2018,G,BOULDER,4171107631,681,84,765,488,63.79%
Colorado,2018,G,BOULDER,4171107632,1232,97,1329,972,73.14%
Colorado,2018,G,BOULDER,4171107633,925,201,1126,545,48.40%
Colorado,2018,G,BOULDER,4171107634,788,149,937,597,63.71%
Colorado,2018,G,BOULDER,4171107635,798,74,872,641,73.51%
Colorado,2018,G,BOULDER,4171107636,1141,85,1226,941,76.75%
Colorado,2018,G,BOULDER,4171107637,1224,204,1428,978,68.49%
Colorado,2018,G,BOULDER,4171107638,959,65,1024,840,82.03%
Colorado,2018,G,BOULDER,4171107639,901,78,979,758,77.43%
Colorado,2018,G,BOULDER,4171107640,861,83,944,723,76.59%
Colorado,2018,G,BOULDER,4171107641,816,89,905,642,70.94%
Colorado,2018,G,BOULDER,4171107642,1250,126,1376,979,71.15%
Colorado,2018,G,BOULDER,4171107643,809,92,901,571,63.37%
Colorado,2018,G,BOULDER,4171107644,870,184,1054,567,53.80%
Colorado,2018,G,BOULDER,4171107645,870,72,942,666,70.70%
Colorado,2018,G,BOULDER,4171107646,940,78,1018,778,76.42%
Colorado,2018,G,BOULDER,4171107647,1473,105,1578,1212,76.81%
Colorado,2018,G,BOULDER,4171107648,1103,172,1275,766,60.08%
Colorado,2018,G,BOULDER,4171107649,817,154,971,564,58.08%
Colorado,2018,G,BOULDER,4171107650,789,93,882,594,67.35%
Colorado,2018,G,BOULDER,4171107651,949,112,1061,742,69.93%
Colorado,2018,G,BOULDER,4171107652,1011,218,1229,741,60.29%
Colorado,2018,G,BOULDER,4171107653,741,32,773,627,81.11%
Colorado,2018,G,BOULDER,4171107654,1321,238,1559,1047,67.16%
Colorado,2018,G,BOULDER,4171207600,1769,153,1922,1477,76.85%
Colorado,2018,G,BOULDER,4171207601,1573,115,1688,1313,77.78%
Colorado,2018,G,BOULDER,4171207602,828,74,902,658,72.95%
Colorado,2018,G,BOULDER,4171207603,1312,129,1441,1061,73.63%
Colorado,2018,G,BOULDER,4171207604,984,88,1072,769,71.74%
Colorado,2018,G,BOULDER,4171207605,1070,93,1163,778,66.90%
Colorado,2018,G,BOULDER,4171207606,906,92,998,682,68.34%
Colorado,2018,G,BOULDER,4171207607,1034,98,1132,801,70.76%
Colorado,2018,G,BOULDER,4171207608,952,154,1106,650,58.77%
Colorado,2018,G,BOULDER,4171207609,523,116,639,311,48.67%
Colorado,2018,G,BOULDER,4171207610,1708,267,1975,1235,62.53%
Colorado,2018,G,BOULDER,4171207611,1115,122,1237,860,69.52%
Colorado,2018,G,BOULDER,4171207612,975,68,1043,816,78.24%
Colorado,2018,G,BOULDER,4171207613,873,71,944,671,71.08%
Colorado,2018,G,BOULDER,4171207614,1447,115,1562,1267,81.11%
Colorado,2018,G,BOULDER,4171207615,803,60,863,681,78.91%
Colorado,2018,G,BOULDER,4181107706,193,10,203,159,78.33%
Colorado,2018,G,BOULDER,4181107707,655,31,686,570,83.09%
Colorado,2018,G,BOULDER,4181107708,699,52,751,584,77.76%
Colorado,2018,G,BROOMFIELD,2233364001,1123,179,1302,924,70.97%
Colorado,2018,G,BROOMFIELD,2233364002,1865,685,2550,1345,52.75%
Colorado,2018,G,BROOMFIELD,2233364003,1360,423,1783,965,54.12%
Colorado,2018,G,BROOMFIELD,2233364004,1636,291,1927,1318,68.40%
Colorado,2018,G,BROOMFIELD,2233364005,98,51,149,49,32.89%
Colorado,2018,G,BROOMFIELD,2233364006,2024,442,2466,1440,58.39%
Colorado,2018,G,BROOMFIELD,2233364007,815,214,1029,620,60.25%
Colorado,2018,G,BROOMFIELD,2233364008,630,156,786,505,64.25%
Colorado,2018,G,BROOMFIELD,2233364009,796,113,909,642,70.63%
Colorado,2018,G,BROOMFIELD,2233364010,1119,84,1203,932,77.47%
Colorado,2018,G,BROOMFIELD,2233364011,1119,116,1235,877,71.01%
Colorado,2018,G,BROOMFIELD,2233364012,1172,69,1241,1029,82.92%
Colorado,2018,G,BROOMFIELD,2233364013,900,152,1052,696,66.16%
Colorado,2018,G,BROOMFIELD,2233364014,995,134,1129,810,71.74%
Colorado,2018,G,BROOMFIELD,2233364015,1098,122,1220,929,76.15%
Colorado,2018,G,BROOMFIELD,2233364016,1133,74,1207,977,80.94%
Colorado,2018,G,BROOMFIELD,2233364017,1506,110,1616,1257,77.78%
Colorado,2018,G,BROOMFIELD,2233364018,838,171,1009,658,65.21%
Colorado,2018,G,BROOMFIELD,2233364019,1250,291,1541,907,58.86%
Colorado,2018,G,BROOMFIELD,2233364020,928,125,1053,748,71.04%
Colorado,2018,G,BROOMFIELD,2233364021,1812,254,2066,1399,67.72%
Colorado,2018,G,BROOMFIELD,2233364022,1244,120,1364,998,73.17%
Colorado,2018,G,BROOMFIELD,2233364023,1089,73,1162,896,77.11%
Colorado,2018,G,BROOMFIELD,2233364024,1951,158,2109,1624,77.00%
Colorado,2018,G,BROOMFIELD,2233364025,1876,204,2080,1567,75.34%
Colorado,2018,G,BROOMFIELD,2233364026,1096,115,1211,970,80.10%
Colorado,2018,G,BROOMFIELD,2233364027,1463,251,1714,1136,66.28%
Colorado,2018,G,BROOMFIELD,2233364028,544,142,686,283,41.25%
Colorado,2018,G,BROOMFIELD,2233364029,1160,110,1270,886,69.76%
Colorado,2018,G,BROOMFIELD,2233364030,1104,151,1255,814,64.86%
Colorado,2018,G,BROOMFIELD,2233364031,995,112,1107,735,66.40%
Colorado,2018,G,BROOMFIELD,2233364032,1964,192,2156,1684,78.11%
Colorado,2018,G,BROOMFIELD,2233364033,1585,163,1748,1329,76.03%
Colorado,2018,G,BROOMFIELD,2233364034,575,43,618,481,77.83%
Colorado,2018,G,BROOMFIELD,2233364035,2024,73,2097,1912,91.18%
Colorado,2018,G,BROOMFIELD,2233364036,2233,168,2401,1877,78.18%
Colorado,2018,G,BROOMFIELD,2233364037,632,34,666,455,68.32%
Colorado,2018,G,CHAFFEE,5056008001,1388,143,1531,1165,76.09%
Colorado,2018,G,CHAFFEE,5056008002,1704,274,1978,1392,70.37%
Colorado,2018,G,CHAFFEE,5056008003,1995,339,2334,1548,66.32%
Colorado,2018,G,CHAFFEE,5056008004,1043,112,1155,884,76.54%
Colorado,2018,G,CHAFFEE,5056008005,1575,222,1797,1338,74.46%
Colorado,2018,G,CHAFFEE,5056008006,1769,248,2017,1495,74.12%
Colorado,2018,G,CHAFFEE,5056008007,1398,213,1611,1190,73.87%
Colorado,2018,G,CHAFFEE,5056008008,1353,253,1606,1155,71.92%
Colorado,2018,G,CHAFFEE,5056008009,1239,248,1487,984,66.17%
Colorado,2018,G,CHEYENNE,4016509001,139,19,158,106,67.09%
Colorado,2018,G,CHEYENNE,4016509002,339,67,406,282,69.46%
Colorado,2018,G,CHEYENNE,4016509003,404,47,451,337,74.72%
Colorado,2018,G,CHEYENNE,4016509004,286,30,316,245,77.53%
Colorado,2018,G,CHEYENNE,4016509005,69,3,72,57,79.17%
Colorado,2018,G,CLEAR CREEK,2021310001,995,187,1182,756,63.96%
Colorado,2018,G,CLEAR CREEK,2021310002,353,96,449,252,56.12%
Colorado,2018,G,CLEAR CREEK,2021310003,429,82,511,313,61.25%
Colorado,2018,G,CLEAR CREEK,2021310004,900,200,1100,641,58.27%
Colorado,2018,G,CLEAR CREEK,2021310005,804,115,919,610,66.38%
Colorado,2018,G,CLEAR CREEK,2021310006,541,131,672,378,56.25%
Colorado,2018,G,CLEAR CREEK,2021310007,1184,196,1380,969,70.22%
Colorado,2018,G,CLEAR CREEK,2021310008,745,80,825,614,74.42%
Colorado,2018,G,CLEAR CREEK,2021310009,1084,126,1210,932,77.02%
Colorado,2018,G,CONEJOS,3356211001,450,40,490,307,62.65%
Colorado,2018,G,CONEJOS,3356211002,503,59,562,376,66.90%
Colorado,2018,G,CONEJOS,3356211003,376,51,427,297,69.56%
Colorado,2018,G,CONEJOS,3356211004,494,47,541,352,65.06%
Colorado,2018,G,CONEJOS,3356211005,525,70,595,365,61.34%
Colorado,2018,G,CONEJOS,3356211006,660,69,729,519,71.19%
Colorado,2018,G,CONEJOS,3356211007,363,36,399,260,65.16%
Colorado,2018,G,CONEJOS,3356211008,736,87,823,543,65.98%
Colorado,2018,G,CONEJOS,3356211009,430,44,474,336,70.89%
Colorado,2018,G,CONEJOS,3356211010,420,54,474,294,62.03%
Colorado,2018,G,COSTILLA,3356212001,222,17,239,156,65.27%
Colorado,2018,G,COSTILLA,3356212002,251,11,262,176,67.18%
Colorado,2018,G,COSTILLA,3356212003,178,11,189,128,67.72%
Colorado,2018,G,COSTILLA,3356212004,333,36,369,210,56.91%
Colorado,2018,G,COSTILLA,3356212005,192,39,231,115,49.78%
Colorado,2018,G,COSTILLA,3356212006,113,15,128,73,57.03%
Colorado,2018,G,COSTILLA,3356212007,718,123,841,525,62.43%
Colorado,2018,G,COSTILLA,3356212008,503,85,588,324,55.10%
Colorado,2018,G,CROWLEY,4356413001,414,50,464,280,60.34%
Colorado,2018,G,CROWLEY,4356413002,335,43,378,247,65.34%
Colorado,2018,G,CROWLEY,4356413003,279,40,319,198,62.07%
Colorado,2018,G,CROWLEY,4356413004,317,28,345,238,68.99%
Colorado,2018,G,CROWLEY,4356413005,324,27,351,247,70.37%
Colorado,2018,G,CROWLEY,4356413006,324,57,381,216,56.69%
Colorado,2018,G,CUSTER,3356014001,1902,244,2146,1485,69.20%
Colorado,2018,G,CUSTER,3356014002,382,55,437,296,67.73%
Colorado,2018,G,CUSTER,3356014003,1375,137,1512,1142,75.53%
Colorado,2018,G,DELTA,3055415001,1117,65,1182,909,76.90%
Colorado,2018,G,DELTA,3055415002,719,102,821,500,60.90%
Colorado,2018,G,DELTA,3055415003,708,139,847,470,55.49%
Colorado,2018,G,DELTA,3055415004,1052,232,1284,717,55.84%
Colorado,2018,G,DELTA,3055415005,776,86,862,574,66.59%
Colorado,2018,G,DELTA,3055415006,1018,117,1135,753,66.34%
Colorado,2018,G,DELTA,3055415007,1022,114,1136,767,67.52%
Colorado,2018,G,DELTA,3056115008,1173,155,1328,796,59.94%
Colorado,2018,G,DELTA,3056115009,1220,108,1328,920,69.28%
Colorado,2018,G,DELTA,3056115010,1044,105,1149,797,69.36%
Colorado,2018,G,DELTA,3056115011,1009,116,1125,791,70.31%
Colorado,2018,G,DELTA,3056115012,788,96,884,583,65.95%
Colorado,2018,G,DELTA,3056115013,969,80,1049,775,73.88%
Colorado,2018,G,DELTA,3056115014,1102,91,1193,917,76.87%
Colorado,2018,G,DELTA,3056115015,1306,116,1422,1078,75.81%
Colorado,2018,G,DELTA,3056115016,1044,124,1168,816,69.86%
Colorado,2018,G,DELTA,3056115017,1014,118,1132,770,68.02%
Colorado,2018,G,DELTA,3056115018,1177,107,1284,928,72.27%
Colorado,2018,G,DELTA,3056115019,813,108,921,662,71.88%
Colorado,2018,G,DELTA,3056115020,1052,109,1161,867,74.68%
Colorado,2018,G,DENVER,1160116112,1082,112,1194,811,67.92%
Colorado,2018,G,DENVER,1160116113,1025,59,1084,791,72.97%
Colorado,2018,G,DENVER,1160116114,1218,156,1374,901,65.57%
Colorado,2018,G,DENVER,1160116120,1478,362,1840,967,52.55%
Colorado,2018,G,DENVER,1160116122,1216,101,1317,937,71.15%
Colorado,2018,G,DENVER,1160116123,1257,145,1402,1024,73.04%
Colorado,2018,G,DENVER,1160116124,1156,87,1243,873,70.23%
Colorado,2018,G,DENVER,1160116125,1271,170,1441,937,65.02%
Colorado,2018,G,DENVER,1160116126,1380,290,1670,972,58.20%
Colorado,2018,G,DENVER,1160116127,1477,274,1751,1107,63.22%
Colorado,2018,G,DENVER,1160116128,951,62,1013,772,76.21%
Colorado,2018,G,DENVER,1160116129,846,70,916,718,78.38%
Colorado,2018,G,DENVER,1160116130,1161,117,1278,831,65.02%
Colorado,2018,G,DENVER,1160116131,1198,123,1321,893,67.60%
Colorado,2018,G,DENVER,1160116132,1263,171,1434,1018,70.99%
Colorado,2018,G,DENVER,1310216204,1527,435,1962,1124,57.29%
Colorado,2018,G,DENVER,1310216205,1441,328,1769,1076,60.83%
Colorado,2018,G,DENVER,1310216206,1700,475,2175,1301,59.82%
Colorado,2018,G,DENVER,1310216207,1396,243,1639,1098,66.99%
Colorado,2018,G,DENVER,1310216208,1435,336,1771,1109,62.62%
Colorado,2018,G,DENVER,1310216209,1122,204,1326,913,68.85%
Colorado,2018,G,DENVER,1310216210,1324,234,1558,1091,70.03%
Colorado,2018,G,DENVER,1310216211,1150,226,1376,950,69.04%
Colorado,2018,G,DENVER,1310516530,127,36,163,75,46.01%
Colorado,2018,G,DENVER,1310616605,841,78,919,740,80.52%
Colorado,2018,G,DENVER,1310616606,957,123,1080,833,77.13%
Colorado,2018,G,DENVER,1310616607,741,68,809,655,80.96%
Colorado,2018,G,DENVER,1310616609,302,25,327,274,83.79%
Colorado,2018,G,DENVER,1310616610,383,44,427,352,82.44%
Colorado,2018,G,DENVER,1310616611,804,89,893,690,77.27%
Colorado,2018,G,DENVER,1310616612,1130,132,1262,929,73.61%
Colorado,2018,G,DENVER,1310616613,1187,115,1302,985,75.65%
Colorado,2018,G,DENVER,1310616614,734,67,801,631,78.78%
Colorado,2018,G,DENVER,1310616615,928,73,1001,830,82.92%
Colorado,2018,G,DENVER,1310616617,1021,128,1149,856,74.50%
Colorado,2018,G,DENVER,1310616618,903,99,1002,788,78.64%
Colorado,2018,G,DENVER,1310616619,1030,93,1123,866,77.11%
Colorado,2018,G,DENVER,1310616622,1157,90,1247,1016,81.48%
Colorado,2018,G,DENVER,1310616623,1244,63,1307,1091,83.47%
Colorado,2018,G,DENVER,1310616624,1250,75,1325,1090,82.26%
Colorado,2018,G,DENVER,1310616625,846,74,920,700,76.09%
Colorado,2018,G,DENVER,1310616626,819,126,945,662,70.05%
Colorado,2018,G,DENVER,1310616627,1144,60,1204,992,82.39%
Colorado,2018,G,DENVER,1310616628,1428,244,1672,1086,64.95%
Colorado,2018,G,DENVER,1310616629,1068,55,1123,951,84.68%
Colorado,2018,G,DENVER,1310616630,820,41,861,690,80.14%
Colorado,2018,G,DENVER,1310616631,1679,490,2169,1223,56.39%
Colorado,2018,G,DENVER,1310616641,1394,167,1561,1084,69.44%
Colorado,2018,G,DENVER,1310616642,1079,94,1173,878,74.85%
Colorado,2018,G,DENVER,1310616643,845,155,1000,600,60.00%
Colorado,2018,G,DENVER,1310616644,1081,95,1176,931,79.17%
Colorado,2018,G,DENVER,1310616645,998,79,1077,837,77.72%
Colorado,2018,G,DENVER,1310616646,1410,458,1868,931,49.84%
Colorado,2018,G,DENVER,1310616647,1218,148,1366,933,68.30%
Colorado,2018,G,DENVER,1310616648,1231,142,1373,991,72.18%
Colorado,2018,G,DENVER,1310616649,1751,586,2337,1077,46.08%
Colorado,2018,G,DENVER,1310616650,1072,220,1292,834,64.55%
Colorado,2018,G,DENVER,1310616651,1190,497,1687,793,47.01%
Colorado,2018,G,DENVER,1310616652,1046,72,1118,938,83.90%
Colorado,2018,G,DENVER,1310816841,1244,297,1541,1009,65.48%
Colorado,2018,G,DENVER,1310816842,1037,161,1198,835,69.70%
Colorado,2018,G,DENVER,1310816843,1101,213,1314,885,67.35%
Colorado,2018,G,DENVER,1310816844,1390,292,1682,1106,65.76%
Colorado,2018,G,DENVER,1310816845,1089,198,1287,887,68.92%
Colorado,2018,G,DENVER,1310816846,1133,227,1360,948,69.71%
Colorado,2018,G,DENVER,1310816848,1198,243,1441,984,68.29%
Colorado,2018,G,DENVER,1310816849,1269,231,1500,1081,72.07%
Colorado,2018,G,DENVER,1310816850,1064,128,1192,951,79.78%
Colorado,2018,G,DENVER,1310816851,1310,168,1478,1106,74.83%
Colorado,2018,G,DENVER,1310816852,952,92,1044,856,81.99%
Colorado,2018,G,DENVER,1310816853,955,50,1005,852,84.78%
Colorado,2018,G,DENVER,1310816854,1082,144,1226,917,74.80%
Colorado,2018,G,DENVER,1310816855,686,154,840,495,58.93%
Colorado,2018,G,DENVER,1310816856,1478,327,1805,1101,61.00%
Colorado,2018,G,DENVER,1310916901,1525,404,1929,1093,56.66%
Colorado,2018,G,DENVER,1310916903,1283,126,1409,1077,76.44%
Colorado,2018,G,DENVER,1310916904,1216,102,1318,1051,79.74%
Colorado,2018,G,DENVER,1310916905,294,20,314,251,79.94%
Colorado,2018,G,DENVER,1310916906,1053,76,1129,901,79.81%
Colorado,2018,G,DENVER,1310916908,1267,161,1428,1020,71.43%
Colorado,2018,G,DENVER,1310916909,1311,98,1409,1122,79.63%
Colorado,2018,G,DENVER,1310916910,1568,205,1773,1235,69.66%
Colorado,2018,G,DENVER,1310916911,1727,459,2186,1128,51.60%
Colorado,2018,G,DENVER,1310916912,1323,280,1603,994,62.01%
Colorado,2018,G,DENVER,1310916916,1699,282,1981,1350,68.15%
Colorado,2018,G,DENVER,1310916917,1438,133,1571,1219,77.59%
Colorado,2018,G,DENVER,1310916918,1298,84,1382,1126,81.48%
Colorado,2018,G,DENVER,1310916919,1306,82,1388,1152,83.00%
Colorado,2018,G,DENVER,1310916920,1262,126,1388,1032,74.35%
Colorado,2018,G,DENVER,1310916921,1698,582,2280,1013,44.43%
Colorado,2018,G,DENVER,1310916922,1697,426,2123,1221,57.51%
Colorado,2018,G,DENVER,1310916923,1414,362,1776,1009,56.81%
Colorado,2018,G,DENVER,1310916924,1222,636,1858,599,32.24%
Colorado,2018,G,DENVER,1310916927,1022,111,1133,842,74.32%
Colorado,2018,G,DENVER,1310916928,857,43,900,741,82.33%
Colorado,2018,G,DENVER,1310916929,945,161,1106,718,64.92%
Colorado,2018,G,DENVER,1310916930,1002,118,1120,710,63.39%
Colorado,2018,G,DENVER,1310916931,762,36,798,677,84.84%
Colorado,2018,G,DENVER,1310916932,1144,172,1316,856,65.05%
Colorado,2018,G,DENVER,1310916933,780,38,818,658,80.44%
Colorado,2018,G,DENVER,1310916934,908,151,1059,685,64.68%
Colorado,2018,G,DENVER,1310916935,1424,446,1870,991,52.99%
Colorado,2018,G,DENVER,1310916936,1076,298,1374,735,53.49%
Colorado,2018,G,DENVER,1310916937,1127,138,1265,929,73.44%
Colorado,2018,G,DENVER,1310916938,1297,233,1530,956,62.48%
Colorado,2018,G,DENVER,1310916940,941,174,1115,699,62.69%
Colorado,2018,G,DENVER,1320116103,1422,143,1565,902,57.64%
Colorado,2018,G,DENVER,1320116104,1186,189,1375,654,47.56%
Colorado,2018,G,DENVER,1320116105,1479,145,1624,974,59.98%
Colorado,2018,G,DENVER,1320116106,1585,168,1753,992,56.59%
Colorado,2018,G,DENVER,1320116107,1640,183,1823,1079,59.19%
Colorado,2018,G,DENVER,1320116108,1642,197,1839,1095,59.54%
Colorado,2018,G,DENVER,1320116109,1074,145,1219,568,46.60%
Colorado,2018,G,DENVER,1320116110,1387,103,1490,1058,71.01%
Colorado,2018,G,DENVER,1320116111,1582,149,1731,1107,63.95%
Colorado,2018,G,DENVER,1320116115,424,34,458,346,75.55%
Colorado,2018,G,DENVER,1320116116,1219,71,1290,937,72.64%
Colorado,2018,G,DENVER,1320116117,1134,82,1216,852,70.07%
Colorado,2018,G,DENVER,1320116118,1183,349,1532,733,47.85%
Colorado,2018,G,DENVER,1320116119,1439,224,1663,721,43.36%
Colorado,2018,G,DENVER,1320116121,1222,84,1306,894,68.45%
Colorado,2018,G,DENVER,1320216212,1347,235,1582,1165,73.64%
Colorado,2018,G,DENVER,1320216213,1072,131,1203,770,64.01%
Colorado,2018,G,DENVER,1320216214,1061,200,1261,849,67.33%
Colorado,2018,G,DENVER,1320216215,1569,273,1842,1264,68.62%
Colorado,2018,G,DENVER,1320216216,1317,190,1507,1098,72.86%
Colorado,2018,G,DENVER,1320216217,1227,171,1398,1022,73.10%
Colorado,2018,G,DENVER,1320216218,923,186,1109,692,62.40%
Colorado,2018,G,DENVER,1320216219,2185,361,2546,1776,69.76%
Colorado,2018,G,DENVER,1320216220,1788,291,2079,1439,69.22%
Colorado,2018,G,DENVER,1320216221,1752,246,1998,1438,71.97%
Colorado,2018,G,DENVER,1320216222,1022,137,1159,865,74.63%
Colorado,2018,G,DENVER,1320216223,860,115,975,731,74.97%
Colorado,2018,G,DENVER,1320216224,1283,170,1453,1043,71.78%
Colorado,2018,G,DENVER,1320216225,843,92,935,714,76.36%
Colorado,2018,G,DENVER,1320216226,872,112,984,716,72.76%
Colorado,2018,G,DENVER,1320216227,917,125,1042,769,73.80%
Colorado,2018,G,DENVER,1320216228,614,37,651,551,84.64%
Colorado,2018,G,DENVER,1320216229,808,60,868,710,81.80%
Colorado,2018,G,DENVER,1320216230,873,66,939,768,81.79%
Colorado,2018,G,DENVER,1320216231,916,96,1012,769,75.99%
Colorado,2018,G,DENVER,1320216232,985,241,1226,687,56.04%
Colorado,2018,G,DENVER,1320216233,1861,226,2087,1570,75.23%
Colorado,2018,G,DENVER,1320216234,1631,182,1813,1405,77.50%
Colorado,2018,G,DENVER,1320216235,1403,133,1536,1236,80.47%
Colorado,2018,G,DENVER,1320216236,1182,135,1317,974,73.96%
Colorado,2018,G,DENVER,1320216237,1406,1095,2501,950,37.98%
Colorado,2018,G,DENVER,1320216238,1850,344,2194,1408,64.18%
Colorado,2018,G,DENVER,1320216239,1297,149,1446,1018,70.40%
Colorado,2018,G,DENVER,1320216240,1082,147,1229,741,60.29%
Colorado,2018,G,DENVER,1320216241,1025,117,1142,842,73.73%
Colorado,2018,G,DENVER,1320216242,991,106,1097,793,72.29%
Colorado,2018,G,DENVER,1320216243,1225,178,1403,986,70.28%
Colorado,2018,G,DENVER,1320216244,1236,249,1485,922,62.09%
Colorado,2018,G,DENVER,1320216245,1138,119,1257,977,77.72%
Colorado,2018,G,DENVER,1320216246,1161,125,1286,976,75.89%
Colorado,2018,G,DENVER,1320216247,829,93,922,645,69.96%
Colorado,2018,G,DENVER,1320216248,1000,61,1061,857,80.77%
Colorado,2018,G,DENVER,1320216249,1309,56,1365,1178,86.30%
Colorado,2018,G,DENVER,1320216250,1244,79,1323,1081,81.71%
Colorado,2018,G,DENVER,1320216251,1035,157,1192,867,72.73%
Colorado,2018,G,DENVER,1320516532,647,121,768,500,65.10%
Colorado,2018,G,DENVER,1320516533,1442,192,1634,925,56.61%
Colorado,2018,G,DENVER,1320516534,1348,144,1492,837,56.10%
Colorado,2018,G,DENVER,1320516535,1489,151,1640,943,57.50%
Colorado,2018,G,DENVER,1320516536,1197,113,1310,706,53.89%
Colorado,2018,G,DENVER,1320516537,1387,194,1581,780,49.34%
Colorado,2018,G,DENVER,1320516538,1140,139,1279,675,52.78%
Colorado,2018,G,DENVER,1320516539,1060,130,1190,636,53.45%
Colorado,2018,G,DENVER,1320616608,1303,87,1390,1152,82.88%
Colorado,2018,G,DENVER,1320616616,1246,80,1326,1101,83.03%
Colorado,2018,G,DENVER,1320616620,1225,267,1492,945,63.34%
Colorado,2018,G,DENVER,1320616621,1165,177,1342,957,71.31%
Colorado,2018,G,DENVER,1320616632,1091,126,1217,954,78.39%
Colorado,2018,G,DENVER,1320616633,1137,84,1221,995,81.49%
Colorado,2018,G,DENVER,1320616634,869,57,926,761,82.18%
Colorado,2018,G,DENVER,1320616635,1333,137,1470,1126,76.60%
Colorado,2018,G,DENVER,1320616636,1142,95,1237,1002,81.00%
Colorado,2018,G,DENVER,1320616637,1160,76,1236,1019,82.44%
Colorado,2018,G,DENVER,1320616638,663,45,708,578,81.64%
Colorado,2018,G,DENVER,1320616639,1032,97,1129,913,80.87%
Colorado,2018,G,DENVER,1320616640,1390,125,1515,1216,80.26%
Colorado,2018,G,DENVER,1320916902,1251,468,1719,818,47.59%
Colorado,2018,G,DENVER,1320916907,1387,263,1650,960,58.18%
Colorado,2018,G,DENVER,1320916913,1400,133,1533,1143,74.56%
Colorado,2018,G,DENVER,1320916914,1072,102,1174,912,77.68%
Colorado,2018,G,DENVER,1320916915,1103,132,1235,882,71.42%
Colorado,2018,G,DENVER,1320916925,737,39,776,622,80.15%
Colorado,2018,G,DENVER,1320916926,763,57,820,627,76.46%
Colorado,2018,G,DENVER,1320916939,773,147,920,568,61.74%
Colorado,2018,G,DENVER,1330516516,723,123,846,478,56.50%
Colorado,2018,G,DENVER,1330516520,2408,2668,5076,652,12.84%
Colorado,2018,G,DENVER,1330516521,1121,179,1300,741,57.00%
Colorado,2018,G,DENVER,1330616601,621,49,670,528,78.81%
Colorado,2018,G,DENVER,1330616602,933,175,1108,734,66.25%
Colorado,2018,G,DENVER,1330616603,985,180,1165,738,63.35%
Colorado,2018,G,DENVER,1330616604,1527,520,2047,903,44.11%
Colorado,2018,G,DENVER,1330716701,1165,212,1377,790,57.37%
Colorado,2018,G,DENVER,1330716702,1352,171,1523,1153,75.71%
Colorado,2018,G,DENVER,1330716703,677,77,754,572,75.86%
Colorado,2018,G,DENVER,1330716704,856,124,980,620,63.27%
Colorado,2018,G,DENVER,1330716705,1376,178,1554,1152,74.13%
Colorado,2018,G,DENVER,1330716706,1061,74,1135,955,84.14%
Colorado,2018,G,DENVER,1330716707,814,88,902,736,81.60%
Colorado,2018,G,DENVER,1330716708,1390,189,1579,1234,78.15%
Colorado,2018,G,DENVER,1330716709,825,99,924,653,70.67%
Colorado,2018,G,DENVER,1330716710,885,88,973,749,76.98%
Colorado,2018,G,DENVER,1330716711,463,61,524,353,67.37%
Colorado,2018,G,DENVER,1330716712,281,45,326,203,62.27%
Colorado,2018,G,DENVER,1330716713,1019,127,1146,862,75.22%
Colorado,2018,G,DENVER,1330716714,1153,239,1392,620,44.54%
Colorado,2018,G,DENVER,1330716715,1138,144,1282,560,43.68%
Colorado,2018,G,DENVER,1330716716,966,145,1111,480,43.20%
Colorado,2018,G,DENVER,1330716717,1087,182,1269,600,47.28%
Colorado,2018,G,DENVER,1330716718,1090,172,1262,565,44.77%
Colorado,2018,G,DENVER,1330716719,943,121,1064,543,51.03%
Colorado,2018,G,DENVER,1330716720,1053,270,1323,562,42.48%
Colorado,2018,G,DENVER,1330716721,903,105,1008,578,57.34%
Colorado,2018,G,DENVER,1330716722,1106,116,1222,645,52.78%
Colorado,2018,G,DENVER,1330716723,1037,88,1125,565,50.22%
Colorado,2018,G,DENVER,1330716724,1013,130,1143,608,53.19%
Colorado,2018,G,DENVER,1330716725,1089,156,1245,588,47.23%
Colorado,2018,G,DENVER,1330716726,1099,149,1248,644,51.60%
Colorado,2018,G,DENVER,1330716727,1121,139,1260,695,55.16%
Colorado,2018,G,DENVER,1330716728,1530,282,1812,896,49.45%
Colorado,2018,G,DENVER,1330716729,2090,242,2332,1408,60.38%
Colorado,2018,G,DENVER,1330716730,1634,142,1776,1217,68.52%
Colorado,2018,G,DENVER,1330716731,1456,218,1674,972,58.06%
Colorado,2018,G,DENVER,1330716732,922,132,1054,592,56.17%
Colorado,2018,G,DENVER,1330716733,1494,393,1887,948,50.24%
Colorado,2018,G,DENVER,1330716734,1217,285,1502,691,46.01%
Colorado,2018,G,DENVER,1330716735,999,161,1160,649,55.95%
Colorado,2018,G,DENVER,1330716736,897,132,1029,545,52.96%
Colorado,2018,G,DENVER,1330716737,995,144,1139,627,55.05%
Colorado,2018,G,DENVER,1330716738,1062,111,1173,642,54.73%
Colorado,2018,G,DENVER,1330716739,1008,134,1142,616,53.94%
Colorado,2018,G,DENVER,1330716740,1012,121,1133,640,56.49%
Colorado,2018,G,DENVER,1330716741,1046,176,1222,643,52.62%
Colorado,2018,G,DENVER,1330716742,712,170,882,438,49.66%
Colorado,2018,G,DENVER,1330716743,900,61,961,828,86.16%
Colorado,2018,G,DENVER,1330716744,1660,212,1872,1372,73.29%
Colorado,2018,G,DENVER,1330716745,1667,61,1728,1450,83.91%
Colorado,2018,G,DENVER,1330716746,750,5,755,643,85.17%
Colorado,2018,G,DENVER,1330816801,942,200,1142,623,54.55%
Colorado,2018,G,DENVER,1330816802,988,112,1100,689,62.64%
Colorado,2018,G,DENVER,1330816803,997,138,1135,592,52.16%
Colorado,2018,G,DENVER,1330816804,874,135,1009,630,62.44%
Colorado,2018,G,DENVER,1330816805,902,171,1073,563,52.47%
Colorado,2018,G,DENVER,1330816806,1215,259,1474,858,58.21%
Colorado,2018,G,DENVER,1330816807,1640,299,1939,1043,53.79%
Colorado,2018,G,DENVER,1330816808,1563,302,1865,1015,54.42%
Colorado,2018,G,DENVER,1330816810,1545,311,1856,1130,60.88%
Colorado,2018,G,DENVER,1330816811,1063,211,1274,780,61.22%
Colorado,2018,G,DENVER,1330816812,1091,202,1293,811,62.72%
Colorado,2018,G,DENVER,1330816813,1110,193,1303,730,56.02%
Colorado,2018,G,DENVER,1330816814,890,117,1007,685,68.02%
Colorado,2018,G,DENVER,1330816815,880,120,1000,700,70.00%
Colorado,2018,G,DENVER,1330816816,846,113,959,666,69.45%
Colorado,2018,G,DENVER,1330816817,1006,87,1093,771,70.54%
Colorado,2018,G,DENVER,1330816818,809,104,913,591,64.73%
Colorado,2018,G,DENVER,1330816819,891,98,989,650,65.72%
Colorado,2018,G,DENVER,1330816820,1031,99,1130,843,74.60%
Colorado,2018,G,DENVER,1330816821,971,117,1088,746,68.57%
Colorado,2018,G,DENVER,1330816822,1080,100,1180,800,67.80%
Colorado,2018,G,DENVER,1330816823,1052,63,1115,923,82.78%
Colorado,2018,G,DENVER,1330816824,1004,85,1089,882,80.99%
Colorado,2018,G,DENVER,1330816825,961,88,1049,816,77.79%
Colorado,2018,G,DENVER,1330816826,1172,222,1394,836,59.97%
Colorado,2018,G,DENVER,1330816827,1277,217,1494,1064,71.22%
Colorado,2018,G,DENVER,1330816828,1751,493,2244,1210,53.92%
Colorado,2018,G,DENVER,1330816829,1580,233,1813,1317,72.64%
Colorado,2018,G,DENVER,1330816830,1116,147,1263,923,73.08%
Colorado,2018,G,DENVER,1330816831,990,42,1032,890,86.24%
Colorado,2018,G,DENVER,1330816832,961,55,1016,886,87.20%
Colorado,2018,G,DENVER,1330816833,1101,78,1179,970,82.27%
Colorado,2018,G,DENVER,1330816834,1043,113,1156,915,79.15%
Colorado,2018,G,DENVER,1330816835,1066,79,1145,948,82.79%
Colorado,2018,G,DENVER,1330816836,1245,430,1675,974,58.15%
Colorado,2018,G,DENVER,1330816837,1209,267,1476,880,59.62%
Colorado,2018,G,DENVER,1330816838,1183,240,1423,764,53.69%
Colorado,2018,G,DENVER,1330816839,537,43,580,472,81.38%
Colorado,2018,G,DENVER,1330816840,553,37,590,503,85.25%
Colorado,2018,G,DENVER,1330816847,599,76,675,487,72.15%
Colorado,2018,G,DENVER,1340116101,1566,233,1799,783,43.52%
Colorado,2018,G,DENVER,1340116102,1563,209,1772,762,43.00%
Colorado,2018,G,DENVER,1340216201,1809,418,2227,1397,62.73%
Colorado,2018,G,DENVER,1340216202,1412,446,1858,1003,53.98%
Colorado,2018,G,DENVER,1340216203,1086,294,1380,795,57.61%
Colorado,2018,G,DENVER,1340416401,1343,122,1465,1035,70.65%
Colorado,2018,G,DENVER,1340416402,1536,385,1921,1154,60.07%
Colorado,2018,G,DENVER,1340416403,1276,138,1414,896,63.37%
Colorado,2018,G,DENVER,1340416404,1382,174,1556,1113,71.53%
Colorado,2018,G,DENVER,1340416405,1287,115,1402,1047,74.68%
Colorado,2018,G,DENVER,1340416406,973,87,1060,787,74.25%
Colorado,2018,G,DENVER,1340416407,1430,169,1599,1181,73.86%
Colorado,2018,G,DENVER,1340416408,1561,154,1715,1219,71.08%
Colorado,2018,G,DENVER,1340416409,1245,89,1334,1037,77.74%
Colorado,2018,G,DENVER,1340416410,1096,122,1218,873,71.67%
Colorado,2018,G,DENVER,1340416411,1143,133,1276,861,67.48%
Colorado,2018,G,DENVER,1340416412,1378,164,1542,1136,73.67%
Colorado,2018,G,DENVER,1340416413,1451,116,1567,1248,79.64%
Colorado,2018,G,DENVER,1340416414,1355,137,1492,1147,76.88%
Colorado,2018,G,DENVER,1340416415,1712,220,1932,1438,74.43%
Colorado,2018,G,DENVER,1340416416,1301,161,1462,1045,71.48%
Colorado,2018,G,DENVER,1340416417,1108,113,1221,904,74.04%
Colorado,2018,G,DENVER,1340416418,1608,262,1870,1246,66.63%
Colorado,2018,G,DENVER,1340416419,1367,145,1512,1172,77.51%
Colorado,2018,G,DENVER,1340416420,1364,172,1536,974,63.41%
Colorado,2018,G,DENVER,1340416421,1490,197,1687,1225,72.61%
Colorado,2018,G,DENVER,1340416422,1426,166,1592,1153,72.42%
Colorado,2018,G,DENVER,1340416423,1303,260,1563,792,50.67%
Colorado,2018,G,DENVER,1340416424,1524,237,1761,1080,61.33%
Colorado,2018,G,DENVER,1340416425,1221,231,1452,707,48.69%
Colorado,2018,G,DENVER,1340416426,1855,483,2338,1181,50.51%
Colorado,2018,G,DENVER,1340416427,454,147,601,138,22.96%
Colorado,2018,G,DENVER,1340416428,1427,270,1697,769,45.32%
Colorado,2018,G,DENVER,1340416429,1403,171,1574,841,53.43%
Colorado,2018,G,DENVER,1340416430,1164,152,1316,746,56.69%
Colorado,2018,G,DENVER,1340416431,1481,134,1615,934,57.83%
Colorado,2018,G,DENVER,1340416432,1316,180,1496,820,54.81%
Colorado,2018,G,DENVER,1340416433,1449,144,1593,854,53.61%
Colorado,2018,G,DENVER,1340416434,1370,198,1568,802,51.15%
Colorado,2018,G,DENVER,1340416435,1206,178,1384,624,45.09%
Colorado,2018,G,DENVER,1340416436,1295,249,1544,574,37.18%
Colorado,2018,G,DENVER,1340516501,1253,151,1404,863,61.47%
Colorado,2018,G,DENVER,1340516502,956,146,1102,519,47.10%
Colorado,2018,G,DENVER,1340516503,1287,218,1505,643,42.72%
Colorado,2018,G,DENVER,1340516504,1092,134,1226,567,46.25%
Colorado,2018,G,DENVER,1340516505,1188,142,1330,727,54.66%
Colorado,2018,G,DENVER,1340516506,1146,121,1267,911,71.90%
Colorado,2018,G,DENVER,1340516507,1303,148,1451,860,59.27%
Colorado,2018,G,DENVER,1340516508,966,109,1075,780,72.56%
Colorado,2018,G,DENVER,1340516509,1412,248,1660,1045,62.95%
Colorado,2018,G,DENVER,1340516510,869,252,1121,511,45.58%
Colorado,2018,G,DENVER,1340516511,1321,174,1495,994,66.49%
Colorado,2018,G,DENVER,1340516512,1531,305,1836,1169,63.67%
Colorado,2018,G,DENVER,1340516513,1395,234,1629,1123,68.94%
Colorado,2018,G,DENVER,1340516514,1566,369,1935,1154,59.64%
Colorado,2018,G,DENVER,1340516515,1629,299,1928,1111,57.62%
Colorado,2018,G,DENVER,1340516517,863,160,1023,643,62.85%
Colorado,2018,G,DENVER,1340516518,843,153,996,601,60.34%
Colorado,2018,G,DENVER,1340516519,1304,580,1884,824,43.74%
Colorado,2018,G,DENVER,1340516522,1788,309,2097,1299,61.95%
Colorado,2018,G,DENVER,1340516523,1561,399,1960,1208,61.63%
Colorado,2018,G,DENVER,1340516524,1287,339,1626,986,60.64%
Colorado,2018,G,DENVER,1340516525,1278,393,1671,891,53.32%
Colorado,2018,G,DENVER,1340516526,939,267,1206,500,41.46%
Colorado,2018,G,DENVER,1340516527,1373,473,1846,730,39.54%
Colorado,2018,G,DENVER,1340516528,1531,386,1917,1050,54.77%
Colorado,2018,G,DENVER,1340516529,1878,361,2239,1477,65.97%
Colorado,2018,G,DENVER,1340516531,1670,259,1929,887,45.98%
Colorado,2018,G,DENVER,1340516540,1313,221,1534,1005,65.51%
Colorado,2018,G,DENVER,1340516541,1680,355,2035,1275,62.65%
Colorado,2018,G,DENVER,1340516542,1113,240,1353,810,59.87%
Colorado,2018,G,DENVER,1340516543,1088,185,1273,758,59.54%
Colorado,2018,G,DENVER,1340816809,956,302,1258,553,43.96%
Colorado,2018,G,DOLORES,3065817001,237,61,298,170,57.05%
Colorado,2018,G,DOLORES,3065817002,311,53,364,264,72.53%
Colorado,2018,G,DOLORES,3065817003,364,44,408,309,75.74%
Colorado,2018,G,DOLORES,3065817004,580,90,670,487,72.69%
Colorado,2018,G,DOUGLAS,4043918106,276,35,311,233,74.92%
Colorado,2018,G,DOUGLAS,4043918107,781,48,829,656,79.13%
Colorado,2018,G,DOUGLAS,4043918306,1073,73,1146,887,77.40%
Colorado,2018,G,DOUGLAS,4043918317,861,63,924,718,77.71%
Colorado,2018,G,DOUGLAS,4043918332,1409,117,1526,1153,75.56%
Colorado,2018,G,DOUGLAS,4043918345,1150,115,1265,949,75.02%
Colorado,2018,G,DOUGLAS,4043918346,1023,53,1076,853,79.28%
Colorado,2018,G,DOUGLAS,4043918358,654,42,696,552,79.31%
Colorado,2018,G,DOUGLAS,4043918401,1061,96,1157,893,77.18%
Colorado,2018,G,DOUGLAS,4043918402,862,55,917,740,80.70%
Colorado,2018,G,DOUGLAS,4043918403,251,46,297,185,62.29%
Colorado,2018,G,DOUGLAS,4043918404,1573,159,1732,1366,78.87%
Colorado,2018,G,DOUGLAS,4043918405,1573,134,1707,1315,77.04%
Colorado,2018,G,DOUGLAS,4043918406,853,98,951,685,72.03%
Colorado,2018,G,DOUGLAS,4043918508,1721,157,1878,1431,76.20%
Colorado,2018,G,DOUGLAS,4043918511,1092,128,1220,901,73.85%
Colorado,2018,G,DOUGLAS,4043918512,1422,140,1562,1135,72.66%
Colorado,2018,G,DOUGLAS,4044418302,1866,230,2096,1411,67.32%
Colorado,2018,G,DOUGLAS,4044418303,1017,195,1212,686,56.60%
Colorado,2018,G,DOUGLAS,4044418304,1550,374,1924,1018,52.91%
Colorado,2018,G,DOUGLAS,4044418309,1768,385,2153,1232,57.22%
Colorado,2018,G,DOUGLAS,4044418315,1693,186,1879,1348,71.74%
Colorado,2018,G,DOUGLAS,4044418316,1158,191,1349,847,62.79%
Colorado,2018,G,DOUGLAS,4044418318,1290,129,1419,1043,73.50%
Colorado,2018,G,DOUGLAS,4044418319,1083,150,1233,842,68.29%
Colorado,2018,G,DOUGLAS,4044418320,1141,153,1294,866,66.92%
Colorado,2018,G,DOUGLAS,4044418321,1307,179,1486,966,65.01%
Colorado,2018,G,DOUGLAS,4044418322,1498,351,1849,1111,60.09%
Colorado,2018,G,DOUGLAS,4044418323,1046,134,1180,825,69.92%
Colorado,2018,G,DOUGLAS,4044418324,1545,160,1705,1250,73.31%
Colorado,2018,G,DOUGLAS,4044418325,1178,125,1303,903,69.30%
Colorado,2018,G,DOUGLAS,4044418326,1699,160,1859,1399,75.26%
Colorado,2018,G,DOUGLAS,4044418327,1449,115,1564,1110,70.97%
Colorado,2018,G,DOUGLAS,4044418328,1156,135,1291,909,70.41%
Colorado,2018,G,DOUGLAS,4044418329,1985,197,2182,1607,73.65%
Colorado,2018,G,DOUGLAS,4044418330,1909,173,2082,1610,77.33%
Colorado,2018,G,DOUGLAS,4044418331,1726,197,1923,1413,73.48%
Colorado,2018,G,DOUGLAS,4044418334,1770,237,2007,1371,68.31%
Colorado,2018,G,DOUGLAS,4044418350,1480,248,1728,1037,60.01%
Colorado,2018,G,DOUGLAS,4044418352,1311,118,1429,1065,74.53%
Colorado,2018,G,DOUGLAS,4044418353,1259,211,1470,929,63.20%
Colorado,2018,G,DOUGLAS,4044418356,1010,309,1319,653,49.51%
Colorado,2018,G,DOUGLAS,4044418357,1238,116,1354,979,72.30%
Colorado,2018,G,DOUGLAS,4044518108,1224,120,1344,926,68.90%
Colorado,2018,G,DOUGLAS,4044518109,1531,177,1708,1215,71.14%
Colorado,2018,G,DOUGLAS,4044518110,1723,225,1948,1257,64.53%
Colorado,2018,G,DOUGLAS,4044518111,1155,137,1292,906,70.12%
Colorado,2018,G,DOUGLAS,4044518112,1958,231,2189,1480,67.61%
Colorado,2018,G,DOUGLAS,4044518113,1684,174,1858,1369,73.68%
Colorado,2018,G,DOUGLAS,4044518114,1950,182,2132,1564,73.36%
Colorado,2018,G,DOUGLAS,4044518116,1138,157,1295,873,67.41%
Colorado,2018,G,DOUGLAS,4044518117,1505,235,1740,1157,66.49%
Colorado,2018,G,DOUGLAS,4044518118,1312,230,1542,957,62.06%
Colorado,2018,G,DOUGLAS,4044518261,1568,143,1711,1328,77.62%
Colorado,2018,G,DOUGLAS,4044518262,1521,226,1747,1223,70.01%
Colorado,2018,G,DOUGLAS,4044518263,1648,153,1801,1411,78.35%
Colorado,2018,G,DOUGLAS,4044518264,1112,380,1492,718,48.12%
Colorado,2018,G,DOUGLAS,4044518269,1359,140,1499,1150,76.72%
Colorado,2018,G,DOUGLAS,4044518333,1627,219,1846,1272,68.91%
Colorado,2018,G,DOUGLAS,4044518335,702,67,769,604,78.54%
Colorado,2018,G,DOUGLAS,4044518336,1319,159,1478,1074,72.67%
Colorado,2018,G,DOUGLAS,4044518337,1126,242,1368,843,61.62%
Colorado,2018,G,DOUGLAS,4044518338,1056,128,1184,826,69.76%
Colorado,2018,G,DOUGLAS,4044518339,1532,171,1703,1161,68.17%
Colorado,2018,G,DOUGLAS,4044518340,1478,141,1619,1194,73.75%
Colorado,2018,G,DOUGLAS,4044518341,1326,87,1413,1104,78.13%
Colorado,2018,G,DOUGLAS,4044518342,1522,150,1672,1268,75.84%
Colorado,2018,G,DOUGLAS,4044518343,1600,229,1829,1228,67.14%
Colorado,2018,G,DOUGLAS,4044518344,1899,130,2029,1471,72.50%
Colorado,2018,G,DOUGLAS,4044518347,864,122,986,645,65.42%
Colorado,2018,G,DOUGLAS,4044518348,1691,245,1936,1356,70.04%
Colorado,2018,G,DOUGLAS,4044518349,1392,49,1441,1144,79.39%
Colorado,2018,G,DOUGLAS,4044518354,1938,178,2116,1557,73.58%
Colorado,2018,G,DOUGLAS,4044518359,957,86,1043,778,74.59%
Colorado,2018,G,DOUGLAS,4044518360,988,81,1069,813,76.05%
Colorado,2018,G,DOUGLAS,4044518501,647,147,794,468,58.94%
Colorado,2018,G,DOUGLAS,4044518502,1335,198,1533,1029,67.12%
Colorado,2018,G,DOUGLAS,4044518503,1533,297,1830,1106,60.44%
Colorado,2018,G,DOUGLAS,4044518504,1658,201,1859,1224,65.84%
Colorado,2018,G,DOUGLAS,4044518505,1353,204,1557,995,63.90%
Colorado,2018,G,DOUGLAS,4044518506,1014,169,1183,711,60.10%
Colorado,2018,G,DOUGLAS,4044518507,1552,170,1722,1223,71.02%
Colorado,2018,G,DOUGLAS,4044518509,1632,151,1783,1344,75.38%
Colorado,2018,G,DOUGLAS,4044518510,2208,227,2435,1795,73.72%
Colorado,2018,G,DOUGLAS,4044518513,1609,332,1941,1226,63.16%
Colorado,2018,G,DOUGLAS,4044518514,1314,243,1557,968,62.17%
Colorado,2018,G,DOUGLAS,4303918101,1408,106,1514,1139,75.23%
Colorado,2018,G,DOUGLAS,4303918102,1853,189,2042,1476,72.28%
Colorado,2018,G,DOUGLAS,4303918103,1713,225,1938,1319,68.06%
Colorado,2018,G,DOUGLAS,4303918104,601,53,654,482,73.70%
Colorado,2018,G,DOUGLAS,4303918105,1677,118,1795,1443,80.39%
Colorado,2018,G,DOUGLAS,4303918115,1370,154,1524,1073,70.41%
Colorado,2018,G,DOUGLAS,4304418206,1029,108,1137,820,72.12%
Colorado,2018,G,DOUGLAS,4304418207,1288,229,1517,905,59.66%
Colorado,2018,G,DOUGLAS,4304418208,1296,532,1828,828,45.30%
Colorado,2018,G,DOUGLAS,4304418232,1051,80,1131,904,79.93%
Colorado,2018,G,DOUGLAS,4304418233,1796,157,1953,1475,75.52%
Colorado,2018,G,DOUGLAS,4304418245,1953,238,2191,1612,73.57%
Colorado,2018,G,DOUGLAS,4304418257,1203,285,1488,873,58.67%
Colorado,2018,G,DOUGLAS,4304418266,1675,129,1804,1373,76.11%
Colorado,2018,G,DOUGLAS,4304418267,1011,118,1129,817,72.36%
Colorado,2018,G,DOUGLAS,4304418301,1556,487,2043,1055,51.64%
Colorado,2018,G,DOUGLAS,4304418307,1443,216,1659,1060,63.89%
Colorado,2018,G,DOUGLAS,4304418308,1472,152,1624,1199,73.83%
Colorado,2018,G,DOUGLAS,4304418311,1328,299,1627,932,57.28%
Colorado,2018,G,DOUGLAS,4304418312,1151,102,1253,965,77.02%
Colorado,2018,G,DOUGLAS,4304418313,1046,71,1117,864,77.35%
Colorado,2018,G,DOUGLAS,4304418314,1024,106,1130,851,75.31%
Colorado,2018,G,DOUGLAS,4304418351,1641,133,1774,1299,73.22%
Colorado,2018,G,DOUGLAS,4304418355,1131,34,1165,854,73.30%
Colorado,2018,G,DOUGLAS,4304518258,1646,148,1794,1383,77.09%
Colorado,2018,G,DOUGLAS,4304518259,1622,120,1742,1341,76.98%
Colorado,2018,G,DOUGLAS,4304518260,1077,83,1160,939,80.95%
Colorado,2018,G,DOUGLAS,4304518268,872,84,956,747,78.14%
Colorado,2018,G,DOUGLAS,6043918305,1692,62,1754,1431,81.58%
Colorado,2018,G,DOUGLAS,6043918310,765,42,807,648,80.30%
Colorado,2018,G,DOUGLAS,6303918243,1718,115,1833,1422,77.58%
Colorado,2018,G,DOUGLAS,6303918247,1509,138,1647,1278,77.60%
Colorado,2018,G,DOUGLAS,6303918249,1432,125,1557,1201,77.14%
Colorado,2018,G,DOUGLAS,6303918250,1176,163,1339,946,70.65%
Colorado,2018,G,DOUGLAS,6303918251,1598,194,1792,1287,71.82%
Colorado,2018,G,DOUGLAS,6303918252,1522,213,1735,1178,67.90%
Colorado,2018,G,DOUGLAS,6303918253,888,71,959,744,77.58%
Colorado,2018,G,DOUGLAS,6303918254,1473,134,1607,1227,76.35%
Colorado,2018,G,DOUGLAS,6303918255,1063,138,1201,849,70.69%
Colorado,2018,G,DOUGLAS,6303918256,913,102,1015,766,75.47%
Colorado,2018,G,DOUGLAS,6303918265,1338,60,1398,1124,80.40%
Colorado,2018,G,DOUGLAS,6304318201,1477,62,1539,1330,86.42%
Colorado,2018,G,DOUGLAS,6304318202,1681,252,1933,1365,70.62%
Colorado,2018,G,DOUGLAS,6304318203,1368,103,1471,1108,75.32%
Colorado,2018,G,DOUGLAS,6304318204,1144,328,1472,763,51.83%
Colorado,2018,G,DOUGLAS,6304318205,1682,435,2117,1261,59.57%
Colorado,2018,G,DOUGLAS,6304318209,1492,122,1614,1237,76.64%
Colorado,2018,G,DOUGLAS,6304318210,1629,215,1844,1296,70.28%
Colorado,2018,G,DOUGLAS,6304318211,1775,292,2067,1432,69.28%
Colorado,2018,G,DOUGLAS,6304318212,1357,116,1473,1102,74.81%
Colorado,2018,G,DOUGLAS,6304318213,1175,60,1235,1045,84.62%
Colorado,2018,G,DOUGLAS,6304318214,710,57,767,618,80.57%
Colorado,2018,G,DOUGLAS,6304318215,1141,83,1224,923,75.41%
Colorado,2018,G,DOUGLAS,6304318216,879,64,943,760,80.59%
Colorado,2018,G,DOUGLAS,6304318217,1188,119,1307,915,70.01%
Colorado,2018,G,DOUGLAS,6304318218,1039,62,1101,879,79.84%
Colorado,2018,G,DOUGLAS,6304318219,979,100,1079,799,74.05%
Colorado,2018,G,DOUGLAS,6304318220,1039,123,1162,856,73.67%
Colorado,2018,G,DOUGLAS,6304318221,957,56,1013,824,81.34%
Colorado,2018,G,DOUGLAS,6304318222,1471,170,1641,1167,71.12%
Colorado,2018,G,DOUGLAS,6304318223,1746,167,1913,1443,75.43%
Colorado,2018,G,DOUGLAS,6304318224,1620,124,1744,1357,77.81%
Colorado,2018,G,DOUGLAS,6304318225,1904,258,2162,1476,68.27%
Colorado,2018,G,DOUGLAS,6304318226,1233,105,1338,1032,77.13%
Colorado,2018,G,DOUGLAS,6304318227,1902,135,2037,1634,80.22%
Colorado,2018,G,DOUGLAS,6304318228,988,92,1080,798,73.89%
Colorado,2018,G,DOUGLAS,6304318229,1204,107,1311,987,75.29%
Colorado,2018,G,DOUGLAS,6304318230,1073,116,1189,871,73.25%
Colorado,2018,G,DOUGLAS,6304318231,1485,151,1636,1195,73.04%
Colorado,2018,G,DOUGLAS,6304318234,1007,58,1065,849,79.72%
Colorado,2018,G,DOUGLAS,6304318235,1641,161,1802,1362,75.58%
Colorado,2018,G,DOUGLAS,6304318236,1907,198,2105,1608,76.39%
Colorado,2018,G,DOUGLAS,6304318237,1360,113,1473,1164,79.02%
Colorado,2018,G,DOUGLAS,6304318238,1294,91,1385,1085,78.34%
Colorado,2018,G,DOUGLAS,6304318239,1880,149,2029,1558,76.79%
Colorado,2018,G,DOUGLAS,6304318240,1233,285,1518,896,59.03%
Colorado,2018,G,DOUGLAS,6304318241,1311,159,1470,1021,69.46%
Colorado,2018,G,DOUGLAS,6304318242,1039,147,1186,805,67.88%
Colorado,2018,G,DOUGLAS,6304318244,1445,120,1565,1179,75.34%
Colorado,2018,G,DOUGLAS,6304318246,1610,141,1751,1300,74.24%
Colorado,2018,G,DOUGLAS,6304318248,1061,94,1155,898,77.75%
Colorado,2018,G,DOUGLAS,6304318270,842,211,1053,611,58.02%
Colorado,2018,G,EAGLE,2052619001,189,37,226,122,53.98%
Colorado,2018,G,EAGLE,2052619002,794,261,1055,552,52.32%
Colorado,2018,G,EAGLE,2052619003,803,171,974,542,55.65%
Colorado,2018,G,EAGLE,2052619011,704,231,935,435,46.52%
Colorado,2018,G,EAGLE,2052619012,1368,384,1752,952,54.34%
Colorado,2018,G,EAGLE,2052619013,926,216,1142,670,58.67%
Colorado,2018,G,EAGLE,2052619014,672,143,815,490,60.12%
Colorado,2018,G,EAGLE,2052619015,1409,488,1897,952,50.18%
Colorado,2018,G,EAGLE,2052619019,1441,300,1741,1041,59.79%
Colorado,2018,G,EAGLE,3052619004,982,113,1095,756,69.04%
Colorado,2018,G,EAGLE,3052619005,1846,311,2157,1386,64.26%
Colorado,2018,G,EAGLE,3052619006,893,121,1014,584,57.59%
Colorado,2018,G,EAGLE,3052619007,1264,149,1413,1034,73.18%
Colorado,2018,G,EAGLE,3052619008,657,82,739,430,58.19%
Colorado,2018,G,EAGLE,3052619009,1039,150,1189,707,59.46%
Colorado,2018,G,EAGLE,3052619010,160,19,179,123,68.72%
Colorado,2018,G,EAGLE,3052619016,631,62,693,502,72.44%
Colorado,2018,G,EAGLE,3052619017,898,181,1079,640,59.31%
Colorado,2018,G,EAGLE,3052619018,838,222,1060,616,58.11%
Colorado,2018,G,EAGLE,3052619020,1380,157,1537,1079,70.20%
Colorado,2018,G,EAGLE,3052619021,293,32,325,229,70.46%
Colorado,2018,G,EAGLE,3052619022,1331,276,1607,846,52.64%
Colorado,2018,G,EAGLE,3052619023,1348,211,1559,853,54.71%
Colorado,2018,G,EAGLE,3052619024,1531,233,1764,1165,66.04%
Colorado,2018,G,EAGLE,3052619025,1294,116,1410,1038,73.62%
Colorado,2018,G,EAGLE,3052619026,1212,129,1341,910,67.86%
Colorado,2018,G,EAGLE,3052619027,1782,191,1973,1463,74.15%
Colorado,2018,G,EAGLE,3052619028,967,117,1084,751,69.28%
Colorado,2018,G,EAGLE,3052619029,1299,243,1542,965,62.58%
Colorado,2018,G,EAGLE,3052619030,1085,122,1207,859,71.17%
Colorado,2018,G,EL PASO,5021821745,270,26,296,216,72.97%
Colorado,2018,G,EL PASO,5021921452,1566,165,1731,1109,64.07%
Colorado,2018,G,EL PASO,5021921500,399,57,456,283,62.06%
Colorado,2018,G,EL PASO,5021921501,1035,141,1176,741,63.01%
Colorado,2018,G,EL PASO,5021921502,892,109,1001,650,64.94%
Colorado,2018,G,EL PASO,5021921521,1221,261,1482,763,51.48%
Colorado,2018,G,EL PASO,5021921522,1367,192,1559,985,63.18%
Colorado,2018,G,EL PASO,5021921523,1147,152,1299,838,64.51%
Colorado,2018,G,EL PASO,5021921524,1562,132,1694,1215,71.72%
Colorado,2018,G,EL PASO,5021921554,159,21,180,121,67.22%
Colorado,2018,G,EL PASO,5021921560,1265,186,1451,847,58.37%
Colorado,2018,G,EL PASO,5021921653,199,14,213,166,77.93%
Colorado,2018,G,EL PASO,5021921828,522,70,592,338,57.09%
Colorado,2018,G,EL PASO,5022021740,1963,243,2206,1549,70.22%
Colorado,2018,G,EL PASO,5022121632,1924,515,2439,1056,43.30%
Colorado,2018,G,EL PASO,5022121639,1978,527,2505,1138,45.43%
Colorado,2018,G,EL PASO,5022121652,1191,140,1331,807,60.63%
Colorado,2018,G,EL PASO,5022121801,1298,318,1616,701,43.38%
Colorado,2018,G,EL PASO,5022121802,1346,240,1586,781,49.24%
Colorado,2018,G,EL PASO,5022121803,1451,339,1790,797,44.53%
Colorado,2018,G,EL PASO,5022121804,1072,232,1304,667,51.15%
Colorado,2018,G,EL PASO,5022121805,1300,227,1527,754,49.38%
Colorado,2018,G,EL PASO,5022121806,1103,181,1284,686,53.43%
Colorado,2018,G,EL PASO,5022121807,1134,319,1453,627,43.15%
Colorado,2018,G,EL PASO,5022121808,1432,408,1840,792,43.04%
Colorado,2018,G,EL PASO,5022121839,950,168,1118,670,59.93%
Colorado,2018,G,EL PASO,5091421215,1953,332,2285,1502,65.73%
Colorado,2018,G,EL PASO,5091421216,2195,230,2425,1660,68.45%
Colorado,2018,G,EL PASO,5091421217,1021,62,1083,836,77.19%
Colorado,2018,G,EL PASO,5091421220,1652,169,1821,1251,68.70%
Colorado,2018,G,EL PASO,5091421221,1715,185,1900,1280,67.37%
Colorado,2018,G,EL PASO,5091421222,1976,181,2157,1524,70.65%
Colorado,2018,G,EL PASO,5091421223,1532,147,1679,1149,68.43%
Colorado,2018,G,EL PASO,5091421224,1578,208,1786,1158,64.84%
Colorado,2018,G,EL PASO,5091421225,1778,216,1994,1401,70.26%
Colorado,2018,G,EL PASO,5091421227,1272,152,1424,973,68.33%
Colorado,2018,G,EL PASO,5091421230,1664,143,1807,1296,71.72%
Colorado,2018,G,EL PASO,5091421231,1589,187,1776,1169,65.82%
Colorado,2018,G,EL PASO,5091421232,1527,242,1769,1176,66.48%
Colorado,2018,G,EL PASO,5091421233,1637,197,1834,1257,68.54%
Colorado,2018,G,EL PASO,5091421234,1667,166,1833,1298,70.81%
Colorado,2018,G,EL PASO,5091421236,1167,157,1324,900,67.98%
Colorado,2018,G,EL PASO,5091421237,1161,206,1367,816,59.69%
Colorado,2018,G,EL PASO,5091421238,1268,169,1437,917,63.81%
Colorado,2018,G,EL PASO,5091421246,1268,300,1568,876,55.87%
Colorado,2018,G,EL PASO,5091421247,1125,163,1288,799,62.03%
Colorado,2018,G,EL PASO,5091521445,1415,215,1630,956,58.65%
Colorado,2018,G,EL PASO,5091521454,1327,126,1453,945,65.04%
Colorado,2018,G,EL PASO,5091821107,1563,373,1936,1021,52.74%
Colorado,2018,G,EL PASO,5091821108,1278,115,1393,991,71.14%
Colorado,2018,G,EL PASO,5091821109,209,34,243,162,66.67%
Colorado,2018,G,EL PASO,5091921209,1560,142,1702,1260,74.03%
Colorado,2018,G,EL PASO,5091921210,1567,203,1770,1243,70.23%
Colorado,2018,G,EL PASO,5091921211,1340,202,1542,1053,68.29%
Colorado,2018,G,EL PASO,5091921212,1685,163,1848,1386,75.00%
Colorado,2018,G,EL PASO,5091921213,1332,100,1432,1056,73.74%
Colorado,2018,G,EL PASO,5091921214,1684,118,1802,1372,76.14%
Colorado,2018,G,EL PASO,5091921218,1059,79,1138,845,74.25%
Colorado,2018,G,EL PASO,5091921219,1349,94,1443,1084,75.12%
Colorado,2018,G,EL PASO,5091921303,1414,137,1551,1135,73.18%
Colorado,2018,G,EL PASO,5091921304,1410,154,1564,1055,67.46%
Colorado,2018,G,EL PASO,5091921310,1726,144,1870,1415,75.67%
Colorado,2018,G,EL PASO,5091921311,1882,149,2031,1521,74.89%
Colorado,2018,G,EL PASO,5091921312,1794,159,1953,1515,77.57%
Colorado,2018,G,EL PASO,5091921313,1540,173,1713,1202,70.17%
Colorado,2018,G,EL PASO,5091921314,1462,125,1587,1214,76.50%
Colorado,2018,G,EL PASO,5091921315,1372,123,1495,1088,72.78%
Colorado,2018,G,EL PASO,5091921316,1281,91,1372,1061,77.33%
Colorado,2018,G,EL PASO,5091921317,1915,164,2079,1580,76.00%
Colorado,2018,G,EL PASO,5091921318,1397,98,1495,1153,77.12%
Colorado,2018,G,EL PASO,5091921319,1334,236,1570,1048,66.75%
Colorado,2018,G,EL PASO,5091921320,1491,123,1614,1204,74.60%
Colorado,2018,G,EL PASO,5091921321,1634,129,1763,1363,77.31%
Colorado,2018,G,EL PASO,5091921322,1488,124,1612,1227,76.12%
Colorado,2018,G,EL PASO,5091921440,1660,135,1795,1355,75.49%
Colorado,2018,G,EL PASO,5091921441,1279,123,1402,1015,72.40%
Colorado,2018,G,EL PASO,5091921442,1815,202,2017,1342,66.53%
Colorado,2018,G,EL PASO,5091921443,1330,174,1504,926,61.57%
Colorado,2018,G,EL PASO,5091921444,1834,155,1989,1384,69.58%
Colorado,2018,G,EL PASO,5091921446,1543,280,1823,1086,59.57%
Colorado,2018,G,EL PASO,5091921447,1420,234,1654,967,58.46%
Colorado,2018,G,EL PASO,5091921448,1347,272,1619,922,56.95%
Colorado,2018,G,EL PASO,5091921449,1103,141,1244,754,60.61%
Colorado,2018,G,EL PASO,5091921450,1261,141,1402,908,64.76%
Colorado,2018,G,EL PASO,5091921525,233,17,250,166,66.40%
Colorado,2018,G,EL PASO,5092021101,1607,261,1868,1104,59.10%
Colorado,2018,G,EL PASO,5092021102,1777,141,1918,1488,77.58%
Colorado,2018,G,EL PASO,5092021103,1711,315,2026,1311,64.71%
Colorado,2018,G,EL PASO,5092021104,1943,312,2255,1508,66.87%
Colorado,2018,G,EL PASO,5092021105,1418,100,1518,1258,82.87%
Colorado,2018,G,EL PASO,5092021106,1638,394,2032,1187,58.42%
Colorado,2018,G,EL PASO,5092021116,1700,167,1867,1437,76.97%
Colorado,2018,G,EL PASO,5092021117,1516,351,1867,1031,55.22%
Colorado,2018,G,EL PASO,5092021200,657,430,1087,301,27.69%
Colorado,2018,G,EL PASO,5092021201,1780,148,1928,1475,76.50%
Colorado,2018,G,EL PASO,5092021202,1650,158,1808,1332,73.67%
Colorado,2018,G,EL PASO,5092021203,1490,131,1621,1210,74.65%
Colorado,2018,G,EL PASO,5092021204,1624,141,1765,1309,74.16%
Colorado,2018,G,EL PASO,5092021205,1721,271,1992,1297,65.11%
Colorado,2018,G,EL PASO,5092021206,1120,170,1290,804,62.33%
Colorado,2018,G,EL PASO,5092021207,1997,282,2279,1567,68.76%
Colorado,2018,G,EL PASO,5092021208,1569,149,1718,1265,73.63%
Colorado,2018,G,EL PASO,5092021226,969,172,1141,696,61.00%
Colorado,2018,G,EL PASO,5092021301,914,66,980,766,78.16%
Colorado,2018,G,EL PASO,5092021302,1915,256,2171,1563,71.99%
Colorado,2018,G,EL PASO,5092021741,486,37,523,404,77.25%
Colorado,2018,G,EL PASO,5101421134,1156,263,1419,768,54.12%
Colorado,2018,G,EL PASO,5101421135,653,168,821,422,51.40%
Colorado,2018,G,EL PASO,5101421141,1522,252,1774,1058,59.64%
Colorado,2018,G,EL PASO,5101421142,1855,239,2094,1369,65.38%
Colorado,2018,G,EL PASO,5101421143,983,132,1115,700,62.78%
Colorado,2018,G,EL PASO,5101421144,1482,179,1661,1075,64.72%
Colorado,2018,G,EL PASO,5101421145,1859,213,2072,1367,65.97%
Colorado,2018,G,EL PASO,5101421146,927,146,1073,693,64.59%
Colorado,2018,G,EL PASO,5101421163,1314,408,1722,869,50.46%
Colorado,2018,G,EL PASO,5101421164,1570,249,1819,1063,58.44%
Colorado,2018,G,EL PASO,5101421235,1752,242,1994,1320,66.20%
Colorado,2018,G,EL PASO,5101421239,1567,318,1885,1140,60.48%
Colorado,2018,G,EL PASO,5101421240,1631,214,1845,1190,64.50%
Colorado,2018,G,EL PASO,5101421241,1923,277,2200,1383,62.86%
Colorado,2018,G,EL PASO,5101421242,1714,415,2129,1163,54.63%
Colorado,2018,G,EL PASO,5101421243,1718,350,2068,1179,57.01%
Colorado,2018,G,EL PASO,5101421244,1782,348,2130,1260,59.15%
Colorado,2018,G,EL PASO,5101421245,1641,250,1891,1323,69.96%
Colorado,2018,G,EL PASO,5101521159,387,48,435,282,64.83%
Colorado,2018,G,EL PASO,5101521401,1565,235,1800,1008,56.00%
Colorado,2018,G,EL PASO,5101521402,1755,382,2137,1156,54.09%
Colorado,2018,G,EL PASO,5101521403,1618,242,1860,1133,60.91%
Colorado,2018,G,EL PASO,5101521404,1501,350,1851,877,47.38%
Colorado,2018,G,EL PASO,5101521405,1385,242,1627,941,57.84%
Colorado,2018,G,EL PASO,5101521406,1538,273,1811,1037,57.26%
Colorado,2018,G,EL PASO,5101521407,1637,289,1926,1123,58.31%
Colorado,2018,G,EL PASO,5101521408,1685,304,1989,1220,61.34%
Colorado,2018,G,EL PASO,5101521417,1497,280,1777,928,52.22%
Colorado,2018,G,EL PASO,5101521423,1324,90,1414,966,68.32%
Colorado,2018,G,EL PASO,5101621120,1065,132,1197,838,70.01%
Colorado,2018,G,EL PASO,5101621121,1925,388,2313,1430,61.82%
Colorado,2018,G,EL PASO,5101621122,1926,594,2520,1124,44.60%
Colorado,2018,G,EL PASO,5101621123,2067,343,2410,1320,54.77%
Colorado,2018,G,EL PASO,5101621124,826,372,1198,560,46.74%
Colorado,2018,G,EL PASO,5101621125,1828,263,2091,1357,64.90%
Colorado,2018,G,EL PASO,5101621126,1914,288,2202,1331,60.45%
Colorado,2018,G,EL PASO,5101621127,1922,201,2123,1419,66.84%
Colorado,2018,G,EL PASO,5101621128,1727,226,1953,1389,71.12%
Colorado,2018,G,EL PASO,5101621129,1853,631,2484,1119,45.05%
Colorado,2018,G,EL PASO,5101621130,1550,267,1817,1084,59.66%
Colorado,2018,G,EL PASO,5101621131,1622,208,1830,1175,64.21%
Colorado,2018,G,EL PASO,5101621132,1505,107,1612,1167,72.39%
Colorado,2018,G,EL PASO,5101621136,1210,242,1452,869,59.85%
Colorado,2018,G,EL PASO,5101621138,880,164,1044,658,63.03%
Colorado,2018,G,EL PASO,5101621140,1536,138,1674,1124,67.14%
Colorado,2018,G,EL PASO,5101621147,1489,309,1798,1026,57.06%
Colorado,2018,G,EL PASO,5101621148,1918,321,2239,1337,59.71%
Colorado,2018,G,EL PASO,5101621149,1723,246,1969,1365,69.32%
Colorado,2018,G,EL PASO,5101621150,1504,107,1611,1146,71.14%
Colorado,2018,G,EL PASO,5101621151,1870,196,2066,1404,67.96%
Colorado,2018,G,EL PASO,5101621152,1772,294,2066,1171,56.68%
Colorado,2018,G,EL PASO,5101621153,1766,228,1994,1279,64.14%
Colorado,2018,G,EL PASO,5101621154,1815,556,2371,1062,44.79%
Colorado,2018,G,EL PASO,5101621157,1473,246,1719,1004,58.41%
Colorado,2018,G,EL PASO,5101621160,1753,292,2045,1244,60.83%
Colorado,2018,G,EL PASO,5101621165,1774,188,1962,1398,71.25%
Colorado,2018,G,EL PASO,5101621166,1740,508,2248,1010,44.93%
Colorado,2018,G,EL PASO,5101621175,1042,112,1154,713,61.79%
Colorado,2018,G,EL PASO,5101621198,954,197,1151,633,55.00%
Colorado,2018,G,EL PASO,5101821171,1342,153,1495,1095,73.24%
Colorado,2018,G,EL PASO,5101821174,923,286,1209,617,51.03%
Colorado,2018,G,EL PASO,5101821181,200,22,222,136,61.26%
Colorado,2018,G,EL PASO,5101821197,1026,153,1179,746,63.27%
Colorado,2018,G,EL PASO,5111721137,850,268,1118,460,41.14%
Colorado,2018,G,EL PASO,5111721182,1580,306,1886,877,46.50%
Colorado,2018,G,EL PASO,5111721183,996,339,1335,592,44.34%
Colorado,2018,G,EL PASO,5111721184,1152,586,1738,538,30.96%
Colorado,2018,G,EL PASO,5111721187,1469,373,1842,922,50.05%
Colorado,2018,G,EL PASO,5111721190,1003,395,1398,516,36.91%
Colorado,2018,G,EL PASO,5111721193,1065,403,1468,615,41.89%
Colorado,2018,G,EL PASO,5111721194,943,291,1234,525,42.54%
Colorado,2018,G,EL PASO,5111721199,953,295,1248,567,45.43%
Colorado,2018,G,EL PASO,5111721610,1397,526,1923,795,41.34%
Colorado,2018,G,EL PASO,5111721611,1717,420,2137,987,46.19%
Colorado,2018,G,EL PASO,5111721612,1616,614,2230,877,39.33%
Colorado,2018,G,EL PASO,5111721613,1728,379,2107,1011,47.98%
Colorado,2018,G,EL PASO,5111721614,1670,844,2514,840,33.41%
Colorado,2018,G,EL PASO,5111721615,1037,250,1287,524,40.71%
Colorado,2018,G,EL PASO,5111721616,1424,291,1715,792,46.18%
Colorado,2018,G,EL PASO,5111721619,1019,276,1295,522,40.31%
Colorado,2018,G,EL PASO,5111721620,811,164,975,512,52.51%
Colorado,2018,G,EL PASO,5111721621,1772,484,2256,924,40.96%
Colorado,2018,G,EL PASO,5111721622,1829,532,2361,940,39.81%
Colorado,2018,G,EL PASO,5111721623,1940,443,2383,1134,47.59%
Colorado,2018,G,EL PASO,5111721624,1639,369,2008,858,42.73%
Colorado,2018,G,EL PASO,5111721625,1745,353,2098,1029,49.05%
Colorado,2018,G,EL PASO,5111721626,1012,744,1756,426,24.26%
Colorado,2018,G,EL PASO,5111721627,1149,261,1410,717,50.85%
Colorado,2018,G,EL PASO,5111721901,690,203,893,409,45.80%
Colorado,2018,G,EL PASO,5111821110,1545,377,1922,1052,54.73%
Colorado,2018,G,EL PASO,5111821111,1266,276,1542,829,53.76%
Colorado,2018,G,EL PASO,5111821112,1634,396,2030,1137,56.01%
Colorado,2018,G,EL PASO,5111821113,1492,310,1802,1082,60.04%
Colorado,2018,G,EL PASO,5111821114,1745,255,2000,1289,64.45%
Colorado,2018,G,EL PASO,5111821118,1718,388,2106,1150,54.61%
Colorado,2018,G,EL PASO,5111821119,1525,295,1820,1091,59.95%
Colorado,2018,G,EL PASO,5111821133,977,154,1131,748,66.14%
Colorado,2018,G,EL PASO,5111821168,1447,217,1664,1193,71.69%
Colorado,2018,G,EL PASO,5111821169,1729,639,2368,847,35.77%
Colorado,2018,G,EL PASO,5111821170,1535,301,1836,1140,62.09%
Colorado,2018,G,EL PASO,5111821172,1447,206,1653,1189,71.93%
Colorado,2018,G,EL PASO,5111821173,1600,264,1864,1166,62.55%
Colorado,2018,G,EL PASO,5111821176,1733,1024,2757,1264,45.85%
Colorado,2018,G,EL PASO,5111821177,1403,718,2121,918,43.28%
Colorado,2018,G,EL PASO,5111821178,1491,324,1815,1092,60.17%
Colorado,2018,G,EL PASO,5111821179,1525,223,1748,1187,67.91%
Colorado,2018,G,EL PASO,5111821180,1674,476,2150,962,44.74%
Colorado,2018,G,EL PASO,5111821185,1456,439,1895,844,44.54%
Colorado,2018,G,EL PASO,5111821186,1790,471,2261,1064,47.06%
Colorado,2018,G,EL PASO,5111821188,1655,397,2052,1065,51.90%
Colorado,2018,G,EL PASO,5111821189,1355,390,1745,854,48.94%
Colorado,2018,G,EL PASO,5111821742,1211,250,1461,930,63.66%
Colorado,2018,G,EL PASO,5111821743,1342,284,1626,1028,63.22%
Colorado,2018,G,EL PASO,5111821744,1220,128,1348,1012,75.07%
Colorado,2018,G,EL PASO,5112021601,1241,328,1569,692,44.10%
Colorado,2018,G,EL PASO,5112021605,1380,345,1725,776,44.99%
Colorado,2018,G,EL PASO,5121521139,1137,374,1511,591,39.11%
Colorado,2018,G,EL PASO,5121521158,1647,221,1868,1224,65.52%
Colorado,2018,G,EL PASO,5121521161,1686,163,1849,1319,71.34%
Colorado,2018,G,EL PASO,5121521162,1388,185,1573,1012,64.34%
Colorado,2018,G,EL PASO,5121521167,1412,208,1620,993,61.30%
Colorado,2018,G,EL PASO,5121521191,1746,324,2070,1191,57.54%
Colorado,2018,G,EL PASO,5121521192,1616,228,1844,1034,56.07%
Colorado,2018,G,EL PASO,5121521195,1437,318,1755,826,47.07%
Colorado,2018,G,EL PASO,5121521196,347,350,697,142,20.37%
Colorado,2018,G,EL PASO,5121521409,1481,215,1696,1128,66.51%
Colorado,2018,G,EL PASO,5121521410,1639,298,1937,1113,57.46%
Colorado,2018,G,EL PASO,5121521411,1832,273,2105,1301,61.81%
Colorado,2018,G,EL PASO,5121521412,1250,240,1490,856,57.45%
Colorado,2018,G,EL PASO,5121521413,1342,217,1559,874,56.06%
Colorado,2018,G,EL PASO,5121521414,1354,260,1614,871,53.97%
Colorado,2018,G,EL PASO,5121521415,1323,254,1577,775,49.14%
Colorado,2018,G,EL PASO,5121521416,1358,273,1631,920,56.41%
Colorado,2018,G,EL PASO,5121521418,1409,216,1625,899,55.32%
Colorado,2018,G,EL PASO,5121521419,1352,247,1599,868,54.28%
Colorado,2018,G,EL PASO,5121521420,1438,83,1521,1000,65.75%
Colorado,2018,G,EL PASO,5121521421,1069,280,1349,647,47.96%
Colorado,2018,G,EL PASO,5121521422,1050,236,1286,634,49.30%
Colorado,2018,G,EL PASO,5121521424,1331,218,1549,889,57.39%
Colorado,2018,G,EL PASO,5121521650,1751,411,2162,976,45.14%
Colorado,2018,G,EL PASO,5121621155,1303,219,1522,868,57.03%
Colorado,2018,G,EL PASO,5121621156,987,108,1095,702,64.11%
Colorado,2018,G,EL PASO,5121721631,504,167,671,277,41.28%
Colorado,2018,G,EL PASO,5121821115,918,220,1138,702,61.69%
Colorado,2018,G,EL PASO,5121821721,1559,142,1701,1291,75.90%
Colorado,2018,G,EL PASO,5121821722,1650,117,1767,1387,78.49%
Colorado,2018,G,EL PASO,5121821723,1809,421,2230,1281,57.44%
Colorado,2018,G,EL PASO,5121821724,1990,501,2491,1357,54.48%
Colorado,2018,G,EL PASO,5121921451,1466,194,1660,1017,61.27%
Colorado,2018,G,EL PASO,5121921453,1425,147,1572,1074,68.32%
Colorado,2018,G,EL PASO,5121921520,136,11,147,107,72.79%
Colorado,2018,G,EL PASO,5121921651,1692,350,2042,946,46.33%
Colorado,2018,G,EL PASO,5122021602,1243,177,1420,970,68.31%
Colorado,2018,G,EL PASO,5122021603,1242,381,1623,795,48.98%
Colorado,2018,G,EL PASO,5122021604,1253,764,2017,659,32.67%
Colorado,2018,G,EL PASO,5122021606,1349,304,1653,940,56.87%
Colorado,2018,G,EL PASO,5122021725,1870,277,2147,1433,66.74%
Colorado,2018,G,EL PASO,5122021726,1738,116,1854,1439,77.62%
Colorado,2018,G,EL PASO,5122021727,1595,121,1716,1312,76.46%
Colorado,2018,G,EL PASO,5122021728,1700,237,1937,1361,70.26%
Colorado,2018,G,EL PASO,5122021729,1871,233,2104,1522,72.34%
Colorado,2018,G,EL PASO,5122021730,1613,264,1877,1203,64.09%
Colorado,2018,G,EL PASO,5122121630,1646,262,1908,977,51.21%
Colorado,2018,G,EL PASO,5122121633,1735,304,2039,1079,52.92%
Colorado,2018,G,EL PASO,5122121634,1738,237,1975,1108,56.10%
Colorado,2018,G,EL PASO,5122121635,1900,332,2232,1171,52.46%
Colorado,2018,G,EL PASO,5122121636,1981,272,2253,1189,52.77%
Colorado,2018,G,EL PASO,5122121637,1808,279,2087,1087,52.08%
Colorado,2018,G,EL PASO,5122121638,1401,186,1587,855,53.88%
Colorado,2018,G,EL PASO,5122121640,1407,292,1699,836,49.21%
Colorado,2018,G,EL PASO,5122121641,1497,226,1723,1016,58.97%
Colorado,2018,G,EL PASO,5122121642,1172,192,1364,757,55.50%
Colorado,2018,G,EL PASO,5122121643,1398,226,1624,870,53.57%
Colorado,2018,G,EL PASO,5122121644,1449,219,1668,890,53.36%
Colorado,2018,G,EL PASO,5122121648,834,205,1039,404,38.88%
Colorado,2018,G,EL PASO,5122121800,1214,2301,3515,255,7.25%
Colorado,2018,G,ELBERT,4016420001,850,132,982,600,61.10%
Colorado,2018,G,ELBERT,4016420002,1608,165,1773,1271,71.69%
Colorado,2018,G,ELBERT,4016420003,1360,126,1486,1101,74.09%
Colorado,2018,G,ELBERT,4016420004,1447,152,1599,1183,73.98%
Colorado,2018,G,ELBERT,4016420005,1108,96,1204,912,75.75%
Colorado,2018,G,ELBERT,4016420006,1601,153,1754,1245,70.98%
Colorado,2018,G,ELBERT,4016420007,1571,124,1695,1231,72.63%
Colorado,2018,G,ELBERT,4016420008,768,61,829,599,72.26%
Colorado,2018,G,ELBERT,4016420009,1393,116,1509,1111,73.62%
Colorado,2018,G,ELBERT,4016420010,1350,122,1472,1077,73.17%
Colorado,2018,G,ELBERT,4016420011,1093,136,1229,880,71.60%
Colorado,2018,G,ELBERT,4016420012,1339,147,1486,992,66.76%
Colorado,2018,G,ELBERT,4016420013,998,94,1092,809,74.08%
Colorado,2018,G,ELBERT,4016420014,1441,171,1612,1103,68.42%
Colorado,2018,G,ELBERT,4016420015,960,146,1106,720,65.10%
Colorado,2018,G,FREMONT,5024722001,972,161,1133,728,64.25%
Colorado,2018,G,FREMONT,5024722002,1118,217,1335,756,56.63%
Colorado,2018,G,FREMONT,5024722003,1138,137,1275,868,68.08%
Colorado,2018,G,FREMONT,5024722025,203,36,239,137,57.32%
Colorado,2018,G,FREMONT,5024722026,540,45,585,412,70.43%
Colorado,2018,G,FREMONT,5024722028,213,23,236,152,64.41%
Colorado,2018,G,FREMONT,5026022004,971,162,1133,629,55.52%
Colorado,2018,G,FREMONT,5026022005,709,117,826,467,56.54%
Colorado,2018,G,FREMONT,5026022006,700,107,807,489,60.59%
Colorado,2018,G,FREMONT,5026022007,1543,244,1787,1116,62.45%
Colorado,2018,G,FREMONT,5026022008,805,106,911,580,63.67%
Colorado,2018,G,FREMONT,5026022009,839,111,950,661,69.58%
Colorado,2018,G,FREMONT,5026022010,1199,127,1326,891,67.19%
Colorado,2018,G,FREMONT,5026022011,1559,170,1729,1300,75.19%
Colorado,2018,G,FREMONT,5026022012,1473,396,1869,1027,54.95%
Colorado,2018,G,FREMONT,5026022013,1018,194,1212,720,59.41%
Colorado,2018,G,FREMONT,5026022014,785,121,906,608,67.11%
Colorado,2018,G,FREMONT,5026022015,648,95,743,481,64.74%
Colorado,2018,G,FREMONT,5026022016,895,131,1026,668,65.11%
Colorado,2018,G,FREMONT,5026022017,843,137,980,629,64.18%
Colorado,2018,G,FREMONT,5026022018,1207,195,1402,832,59.34%
Colorado,2018,G,FREMONT,5026022019,1720,294,2014,1212,60.18%
Colorado,2018,G,FREMONT,5026022020,1336,247,1583,897,56.66%
Colorado,2018,G,FREMONT,5026022021,631,69,700,482,68.86%
Colorado,2018,G,FREMONT,5026022022,1546,266,1812,1165,64.29%
Colorado,2018,G,FREMONT,5026022023,409,67,476,341,71.64%
Colorado,2018,G,FREMONT,5026022024,669,89,758,567,74.80%
Colorado,2018,G,FREMONT,5026022027,233,36,269,181,67.29%
Colorado,2018,G,FREMONT,5026022029,557,47,604,414,68.54%
Colorado,2018,G,FREMONT,5026022030,734,214,948,515,54.32%
Colorado,2018,G,GARFIELD,3085723001,1608,252,1860,1244,66.88%
Colorado,2018,G,GARFIELD,3085723002,1595,127,1722,1358,78.86%
Colorado,2018,G,GARFIELD,3085723003,1582,201,1783,1272,71.34%
Colorado,2018,G,GARFIELD,3085723004,1580,158,1738,1285,73.94%
Colorado,2018,G,GARFIELD,3085723005,1521,238,1759,1156,65.72%
Colorado,2018,G,GARFIELD,3085723006,1041,188,1229,764,62.16%
Colorado,2018,G,GARFIELD,3085723007,860,146,1006,656,65.21%
Colorado,2018,G,GARFIELD,3085723008,913,153,1066,675,63.32%
Colorado,2018,G,GARFIELD,3085723009,1049,145,1194,840,70.35%
Colorado,2018,G,GARFIELD,3085723010,1587,147,1734,1244,71.74%
Colorado,2018,G,GARFIELD,3085723011,910,99,1009,740,73.34%
Colorado,2018,G,GARFIELD,3085723012,1236,152,1388,829,59.73%
Colorado,2018,G,GARFIELD,3085723013,810,120,930,502,53.98%
Colorado,2018,G,GARFIELD,3085723014,1599,232,1831,1228,67.07%
Colorado,2018,G,GARFIELD,3085723015,1567,169,1736,1154,66.47%
Colorado,2018,G,GARFIELD,3085723016,1552,217,1769,1120,63.31%
Colorado,2018,G,GARFIELD,3085723017,1285,142,1427,998,69.94%
Colorado,2018,G,GARFIELD,3085723018,709,54,763,562,73.66%
Colorado,2018,G,GARFIELD,3085723019,1508,204,1712,1105,64.54%
Colorado,2018,G,GARFIELD,3085723020,1287,226,1513,940,62.13%
Colorado,2018,G,GARFIELD,3085723021,1358,187,1545,985,63.75%
Colorado,2018,G,GARFIELD,3085723022,1185,255,1440,727,50.49%
Colorado,2018,G,GARFIELD,3085723023,924,225,1149,621,54.05%
Colorado,2018,G,GARFIELD,3085723024,535,59,594,446,75.08%
Colorado,2018,G,GARFIELD,3085723025,683,159,842,445,52.85%
Colorado,2018,G,GARFIELD,3085723026,1322,241,1563,993,63.53%
Colorado,2018,G,GARFIELD,3085723027,1006,229,1235,627,50.77%
Colorado,2018,G,GILPIN,2161324001,689,185,874,488,55.84%
Colorado,2018,G,GILPIN,2161324002,747,88,835,595,71.26%
Colorado,2018,G,GILPIN,2161324003,883,130,1013,702,69.30%
Colorado,2018,G,GILPIN,2161324004,691,127,818,512,62.59%
Colorado,2018,G,GILPIN,2161324005,636,99,735,490,66.67%
Colorado,2018,G,GILPIN,2161324006,835,109,944,638,67.58%
Colorado,2018,G,GRAND,2081325001,746,108,854,552,64.64%
Colorado,2018,G,GRAND,2081325002,1248,113,1361,917,67.38%
Colorado,2018,G,GRAND,2081325003,1590,221,1811,1130,62.40%
Colorado,2018,G,GRAND,2081325004,729,91,820,508,61.95%
Colorado,2018,G,GRAND,2081325005,1033,101,1134,727,64.11%
Colorado,2018,G,GRAND,2081325006,683,126,809,494,61.06%
Colorado,2018,G,GRAND,2081325007,1013,180,1193,725,60.77%
Colorado,2018,G,GRAND,2081325008,746,82,828,550,66.43%
Colorado,2018,G,GRAND,2081325009,663,94,757,528,69.75%
Colorado,2018,G,GRAND,2081325010,784,102,886,577,65.12%
Colorado,2018,G,GRAND,2081325011,631,79,710,475,66.90%
Colorado,2018,G,GRAND,2081325012,929,97,1026,725,70.66%
Colorado,2018,G,GUNNISON,3055926008,756,131,887,613,69.11%
Colorado,2018,G,GUNNISON,3055926009,881,222,1103,712,64.55%
Colorado,2018,G,GUNNISON,3055926010,649,391,1040,413,39.71%
Colorado,2018,G,GUNNISON,3055926012,222,46,268,161,60.07%
Colorado,2018,G,GUNNISON,3055926013,1169,157,1326,969,73.08%
Colorado,2018,G,GUNNISON,3055926014,1162,376,1538,871,56.63%
Colorado,2018,G,GUNNISON,3055926015,549,175,724,409,56.49%
Colorado,2018,G,GUNNISON,3056126001,82,38,120,52,43.33%
Colorado,2018,G,GUNNISON,3056126002,312,34,346,231,66.76%
Colorado,2018,G,GUNNISON,3056126003,1359,222,1581,1108,70.08%
Colorado,2018,G,GUNNISON,3056126004,765,200,965,575,59.59%
Colorado,2018,G,GUNNISON,3056126005,1775,220,1995,1460,73.18%
Colorado,2018,G,GUNNISON,3056126006,759,150,909,558,61.39%
Colorado,2018,G,GUNNISON,3056126007,709,92,801,583,72.78%
Colorado,2018,G,GUNNISON,3056126011,341,39,380,278,73.16%
Colorado,2018,G,HINSDALE,3055927001,690,88,778,589,75.71%
Colorado,2018,G,HUERFANO,3356228001,395,52,447,326,72.93%
Colorado,2018,G,HUERFANO,3356228002,714,87,801,582,72.66%
Colorado,2018,G,HUERFANO,3356228003,496,64,560,381,68.04%
Colorado,2018,G,HUERFANO,3356228004,711,112,823,510,61.97%
Colorado,2018,G,HUERFANO,3356228005,208,22,230,179,77.83%
Colorado,2018,G,HUERFANO,3356228006,618,109,727,453,62.31%
Colorado,2018,G,HUERFANO,3356228007,224,62,286,164,57.34%
Colorado,2018,G,HUERFANO,3356228008,109,19,128,79,61.72%
Colorado,2018,G,HUERFANO,3356228009,686,87,773,533,68.95%
Colorado,2018,G,HUERFANO,3356228010,459,62,521,388,74.47%
Colorado,2018,G,HUERFANO,3356228011,141,15,156,115,73.72%
Colorado,2018,G,JACKSON,3081329001,374,93,467,308,65.95%
Colorado,2018,G,JACKSON,3081329002,72,14,86,57,66.28%
Colorado,2018,G,JACKSON,3081329003,122,21,143,114,79.72%
Colorado,2018,G,JACKSON,3081329004,50,13,63,35,55.56%
Colorado,2018,G,JACKSON,3081329005,368,107,475,300,63.16%
Colorado,2018,G,JEFFERSON,1160130001,227,5,232,197,84.91%
Colorado,2018,G,JEFFERSON,1162230002,1217,226,1443,928,64.31%
Colorado,2018,G,JEFFERSON,1162230003,1280,107,1387,1072,77.29%
Colorado,2018,G,JEFFERSON,1162230004,1710,146,1856,1302,70.15%
Colorado,2018,G,JEFFERSON,1162230005,1499,124,1623,1222,75.29%
Colorado,2018,G,JEFFERSON,1162230006,1630,108,1738,1385,79.69%
Colorado,2018,G,JEFFERSON,1162230007,1765,169,1934,1357,70.17%
Colorado,2018,G,JEFFERSON,1162230008,1571,198,1769,1197,67.67%
Colorado,2018,G,JEFFERSON,1162230009,1746,99,1845,1471,79.73%
Colorado,2018,G,JEFFERSON,1162230010,850,45,895,718,80.22%
Colorado,2018,G,JEFFERSON,1162230011,1087,82,1169,879,75.19%
Colorado,2018,G,JEFFERSON,1162230012,1726,129,1855,1457,78.54%
Colorado,2018,G,JEFFERSON,1162230013,831,112,943,678,71.90%
Colorado,2018,G,JEFFERSON,1162230014,1194,96,1290,931,72.17%
Colorado,2018,G,JEFFERSON,1202230015,415,65,480,315,65.63%
Colorado,2018,G,JEFFERSON,1222230016,1794,246,2040,1354,66.37%
Colorado,2018,G,JEFFERSON,1222230017,1054,169,1223,825,67.46%
Colorado,2018,G,JEFFERSON,1222230018,1687,148,1835,1437,78.31%
Colorado,2018,G,JEFFERSON,1222230019,1833,161,1994,1505,75.48%
Colorado,2018,G,JEFFERSON,1222230020,1853,146,1999,1489,74.49%
Colorado,2018,G,JEFFERSON,1222230021,1716,102,1818,1405,77.28%
Colorado,2018,G,JEFFERSON,1222230022,1188,96,1284,951,74.07%
Colorado,2018,G,JEFFERSON,1222230023,1646,167,1813,1372,75.68%
Colorado,2018,G,JEFFERSON,1222230024,1689,144,1833,1418,77.36%
Colorado,2018,G,JEFFERSON,1222230025,1369,95,1464,1080,73.77%
Colorado,2018,G,JEFFERSON,1222230026,1864,169,2033,1410,69.36%
Colorado,2018,G,JEFFERSON,1222230027,1570,93,1663,1354,81.42%
Colorado,2018,G,JEFFERSON,1222230028,1028,224,1252,745,59.50%
Colorado,2018,G,JEFFERSON,1222230029,1584,191,1775,1189,66.99%
Colorado,2018,G,JEFFERSON,1222230030,1712,209,1921,1431,74.49%
Colorado,2018,G,JEFFERSON,1222230031,1308,120,1428,984,68.91%
Colorado,2018,G,JEFFERSON,1222230032,1372,238,1610,985,61.18%
Colorado,2018,G,JEFFERSON,1222230033,1860,200,2060,1412,68.54%
Colorado,2018,G,JEFFERSON,1222230034,1806,206,2012,1430,71.07%
Colorado,2018,G,JEFFERSON,1222230035,1207,113,1320,970,73.48%
Colorado,2018,G,JEFFERSON,2162530036,1819,175,1994,1486,74.52%
Colorado,2018,G,JEFFERSON,2162530037,1154,134,1288,1005,78.03%
Colorado,2018,G,JEFFERSON,2162530038,1287,120,1407,1050,74.63%
Colorado,2018,G,JEFFERSON,2162530039,1384,133,1517,1156,76.20%
Colorado,2018,G,JEFFERSON,2162530040,1669,159,1828,1447,79.16%
Colorado,2018,G,JEFFERSON,2162530041,1011,81,1092,880,80.59%
Colorado,2018,G,JEFFERSON,2162530042,1250,125,1375,1057,76.87%
Colorado,2018,G,JEFFERSON,2162530043,861,73,934,736,78.80%
Colorado,2018,G,JEFFERSON,2162530044,1066,156,1222,867,70.95%
Colorado,2018,G,JEFFERSON,2162530045,1133,84,1217,939,77.16%
Colorado,2018,G,JEFFERSON,2162530046,1149,158,1307,932,71.31%
Colorado,2018,G,JEFFERSON,2162530047,1192,123,1315,1006,76.50%
Colorado,2018,G,JEFFERSON,2162530048,1296,140,1436,1122,78.13%
Colorado,2018,G,JEFFERSON,2162530049,1198,131,1329,987,74.27%
Colorado,2018,G,JEFFERSON,2162530050,1171,117,1288,1001,77.72%
Colorado,2018,G,JEFFERSON,2162530051,1431,175,1606,1171,72.91%
Colorado,2018,G,JEFFERSON,2162530052,1317,147,1464,1111,75.89%
Colorado,2018,G,JEFFERSON,2162530053,1007,89,1096,868,79.20%
Colorado,2018,G,JEFFERSON,2162530054,1247,118,1365,1056,77.36%
Colorado,2018,G,JEFFERSON,2162530055,638,89,727,523,71.94%
Colorado,2018,G,JEFFERSON,2162530056,1039,106,1145,874,76.33%
Colorado,2018,G,JEFFERSON,2162530057,1287,147,1434,1053,73.43%
Colorado,2018,G,JEFFERSON,2162530058,1720,152,1872,1422,75.96%
Colorado,2018,G,JEFFERSON,2162530059,1310,161,1471,1041,70.77%
Colorado,2018,G,JEFFERSON,2162530060,600,93,693,502,72.44%
Colorado,2018,G,JEFFERSON,2162530061,1337,189,1526,1080,70.77%
Colorado,2018,G,JEFFERSON,2162530062,1413,174,1587,1188,74.86%
Colorado,2018,G,JEFFERSON,2162530063,1109,112,1221,904,74.04%
Colorado,2018,G,JEFFERSON,2162530064,635,35,670,546,81.49%
Colorado,2018,G,JEFFERSON,2162530065,1466,156,1622,1195,73.67%
Colorado,2018,G,JEFFERSON,2162530066,1300,122,1422,1099,77.29%
Colorado,2018,G,JEFFERSON,2162530067,1212,174,1386,992,71.57%
Colorado,2018,G,JEFFERSON,2162530068,997,61,1058,840,79.40%
Colorado,2018,G,JEFFERSON,2202230069,602,84,686,486,70.85%
Colorado,2018,G,JEFFERSON,2202530070,1830,167,1997,1413,70.76%
Colorado,2018,G,JEFFERSON,2202530071,1686,146,1832,1330,72.60%
Colorado,2018,G,JEFFERSON,2202530072,1808,238,2046,1346,65.79%
Colorado,2018,G,JEFFERSON,2202530073,1844,156,2000,1405,70.25%
Colorado,2018,G,JEFFERSON,2202530074,1728,169,1897,1386,73.06%
Colorado,2018,G,JEFFERSON,2202530075,1822,302,2124,1425,67.09%
Colorado,2018,G,JEFFERSON,2202530076,1638,145,1783,1289,72.29%
Colorado,2018,G,JEFFERSON,2202530077,1565,79,1644,1395,84.85%
Colorado,2018,G,JEFFERSON,2202530078,1375,86,1461,1208,82.68%
Colorado,2018,G,JEFFERSON,2202530079,840,44,884,736,83.26%
Colorado,2018,G,JEFFERSON,2202530080,1212,99,1311,1038,79.18%
Colorado,2018,G,JEFFERSON,2222230081,1539,112,1651,1266,76.68%
Colorado,2018,G,JEFFERSON,2222230082,1328,73,1401,1092,77.94%
Colorado,2018,G,JEFFERSON,2222530083,926,58,984,790,80.28%
Colorado,2018,G,JEFFERSON,7162430084,1619,320,1939,1144,59.00%
Colorado,2018,G,JEFFERSON,7162430085,1766,373,2139,1234,57.69%
Colorado,2018,G,JEFFERSON,7162430086,1537,140,1677,1335,79.61%
Colorado,2018,G,JEFFERSON,7162430087,936,104,1040,806,77.50%
Colorado,2018,G,JEFFERSON,7162430088,1729,342,2071,1284,62.00%
Colorado,2018,G,JEFFERSON,7162430089,1372,338,1710,1030,60.23%
Colorado,2018,G,JEFFERSON,7162430090,1582,501,2083,1150,55.21%
Colorado,2018,G,JEFFERSON,7162430091,1502,69,1571,1327,84.47%
Colorado,2018,G,JEFFERSON,7162430092,1188,92,1280,1063,83.05%
Colorado,2018,G,JEFFERSON,7162430093,1677,279,1956,1409,72.03%
Colorado,2018,G,JEFFERSON,7162430094,1237,263,1500,1001,66.73%
Colorado,2018,G,JEFFERSON,7162430095,1297,169,1466,1080,73.67%
Colorado,2018,G,JEFFERSON,7162530096,138,20,158,123,77.85%
Colorado,2018,G,JEFFERSON,7162530097,369,24,393,319,81.17%
Colorado,2018,G,JEFFERSON,7192430098,1008,71,1079,876,81.19%
Colorado,2018,G,JEFFERSON,7192730099,1914,124,2038,1652,81.06%
Colorado,2018,G,JEFFERSON,7192730100,1986,151,2137,1676,78.43%
Colorado,2018,G,JEFFERSON,7192730101,1992,162,2154,1566,72.70%
Colorado,2018,G,JEFFERSON,7192730102,1316,88,1404,1076,76.64%
Colorado,2018,G,JEFFERSON,7192730103,1770,116,1886,1511,80.12%
Colorado,2018,G,JEFFERSON,7192730104,1238,133,1371,978,71.33%
Colorado,2018,G,JEFFERSON,7192730105,1503,242,1745,1112,63.72%
Colorado,2018,G,JEFFERSON,7192730106,1952,198,2150,1578,73.40%
Colorado,2018,G,JEFFERSON,7192730107,1688,159,1847,1401,75.85%
Colorado,2018,G,JEFFERSON,7192730108,1319,146,1465,1051,71.74%
Colorado,2018,G,JEFFERSON,7192730109,1418,164,1582,1124,71.05%
Colorado,2018,G,JEFFERSON,7192730110,1531,126,1657,1259,75.98%
Colorado,2018,G,JEFFERSON,7192730111,1942,210,2152,1573,73.09%
Colorado,2018,G,JEFFERSON,7192730112,1570,219,1789,1190,66.52%
Colorado,2018,G,JEFFERSON,7192730113,1648,86,1734,1430,82.47%
Colorado,2018,G,JEFFERSON,7192730114,1701,188,1889,1366,72.31%
Colorado,2018,G,JEFFERSON,7192730115,1848,150,1998,1551,77.63%
Colorado,2018,G,JEFFERSON,7192730116,1565,70,1635,1347,82.39%
Colorado,2018,G,JEFFERSON,7192730117,1678,140,1818,1377,75.74%
Colorado,2018,G,JEFFERSON,7192730118,1734,111,1845,1503,81.46%
Colorado,2018,G,JEFFERSON,7192730119,2064,375,2439,1409,57.77%
Colorado,2018,G,JEFFERSON,7192730120,2099,519,2618,1561,59.63%
Colorado,2018,G,JEFFERSON,7192730121,1607,265,1872,1219,65.12%
Colorado,2018,G,JEFFERSON,7192730122,1991,299,2290,1451,63.36%
Colorado,2018,G,JEFFERSON,7192730123,1800,201,2001,1445,72.21%
Colorado,2018,G,JEFFERSON,7192730124,1862,272,2134,1424,66.73%
Colorado,2018,G,JEFFERSON,7192730125,1387,274,1661,986,59.36%
Colorado,2018,G,JEFFERSON,7192730126,1901,260,2161,1515,70.11%
Colorado,2018,G,JEFFERSON,7192930127,1624,149,1773,1291,72.81%
Colorado,2018,G,JEFFERSON,7192930128,2258,363,2621,1673,63.83%
Colorado,2018,G,JEFFERSON,7192930129,1306,156,1462,1010,69.08%
Colorado,2018,G,JEFFERSON,7192930130,1358,141,1499,1044,69.65%
Colorado,2018,G,JEFFERSON,7192930131,1346,172,1518,1009,66.47%
Colorado,2018,G,JEFFERSON,7192930132,1373,97,1470,1086,73.88%
Colorado,2018,G,JEFFERSON,7192930133,1993,554,2547,1427,56.03%
Colorado,2018,G,JEFFERSON,7192930134,1315,158,1473,1027,69.72%
Colorado,2018,G,JEFFERSON,7192930135,942,86,1028,736,71.60%
Colorado,2018,G,JEFFERSON,7192930136,1747,132,1879,1407,74.88%
Colorado,2018,G,JEFFERSON,7192930137,1786,171,1957,1372,70.11%
Colorado,2018,G,JEFFERSON,7192930138,1413,113,1526,1158,75.88%
Colorado,2018,G,JEFFERSON,7192930139,1632,195,1827,1183,64.75%
Colorado,2018,G,JEFFERSON,7192930140,1545,155,1700,1150,67.65%
Colorado,2018,G,JEFFERSON,7192930141,1774,210,1984,1368,68.95%
Colorado,2018,G,JEFFERSON,7192930142,2078,311,2389,1642,68.73%
Colorado,2018,G,JEFFERSON,7192930143,1623,166,1789,1307,73.06%
Colorado,2018,G,JEFFERSON,7192930144,1394,135,1529,1095,71.62%
Colorado,2018,G,JEFFERSON,7192930145,1353,178,1531,977,63.81%
Colorado,2018,G,JEFFERSON,7192930146,2535,447,2982,1687,56.57%
Colorado,2018,G,JEFFERSON,7192930147,2048,275,2323,1504,64.74%
Colorado,2018,G,JEFFERSON,7192930148,1899,207,2106,1424,67.62%
Colorado,2018,G,JEFFERSON,7192930149,1756,184,1940,1308,67.42%
Colorado,2018,G,JEFFERSON,7192930150,1445,120,1565,1098,70.16%
Colorado,2018,G,JEFFERSON,7192930151,1918,209,2127,1383,65.02%
Colorado,2018,G,JEFFERSON,7192930152,1585,142,1727,1337,77.42%
Colorado,2018,G,JEFFERSON,7192930153,1879,350,2229,1375,61.69%
Colorado,2018,G,JEFFERSON,7192930154,1855,235,2090,1309,62.63%
Colorado,2018,G,JEFFERSON,7192930155,1776,178,1954,1385,70.88%
Colorado,2018,G,JEFFERSON,7192930156,1663,168,1831,1292,70.56%
Colorado,2018,G,JEFFERSON,7192930157,1518,223,1741,1087,62.44%
Colorado,2018,G,JEFFERSON,7202330158,1730,291,2021,1300,64.32%
Colorado,2018,G,JEFFERSON,7202330159,1946,398,2344,1398,59.64%
Colorado,2018,G,JEFFERSON,7202330160,1486,354,1840,976,53.04%
Colorado,2018,G,JEFFERSON,7202330161,1021,198,1219,726,59.56%
Colorado,2018,G,JEFFERSON,7202330162,1318,180,1498,1028,68.62%
Colorado,2018,G,JEFFERSON,7202330163,1433,307,1740,1080,62.07%
Colorado,2018,G,JEFFERSON,7202330164,1770,105,1875,1491,79.52%
Colorado,2018,G,JEFFERSON,7202330165,1738,163,1901,1494,78.59%
Colorado,2018,G,JEFFERSON,7202330166,1738,202,1940,1436,74.02%
Colorado,2018,G,JEFFERSON,7202330167,1030,381,1411,772,54.71%
Colorado,2018,G,JEFFERSON,7202330168,999,79,1078,817,75.79%
Colorado,2018,G,JEFFERSON,7202330169,1398,98,1496,1193,79.75%
Colorado,2018,G,JEFFERSON,7202330170,1535,106,1641,1291,78.67%
Colorado,2018,G,JEFFERSON,7202330171,1861,158,2019,1568,77.66%
Colorado,2018,G,JEFFERSON,7202330172,1734,256,1990,1383,69.50%
Colorado,2018,G,JEFFERSON,7202330173,1802,584,2386,1243,52.10%
Colorado,2018,G,JEFFERSON,7202330174,1803,178,1981,1387,70.02%
Colorado,2018,G,JEFFERSON,7202330175,1844,250,2094,1396,66.67%
Colorado,2018,G,JEFFERSON,7202330176,1474,94,1568,1243,79.27%
Colorado,2018,G,JEFFERSON,7202330177,1921,214,2135,1499,70.21%
Colorado,2018,G,JEFFERSON,7202330178,1839,355,2194,1400,63.81%
Colorado,2018,G,JEFFERSON,7202330179,1805,259,2064,1474,71.41%
Colorado,2018,G,JEFFERSON,7202330180,1359,207,1566,987,63.03%
Colorado,2018,G,JEFFERSON,7202330181,1594,174,1768,1278,72.29%
Colorado,2018,G,JEFFERSON,7202430182,1917,109,2026,1643,81.10%
Colorado,2018,G,JEFFERSON,7202430183,1400,68,1468,1199,81.68%
Colorado,2018,G,JEFFERSON,7202430184,1818,196,2014,1486,73.78%
Colorado,2018,G,JEFFERSON,7202430185,1498,162,1660,1201,72.35%
Colorado,2018,G,JEFFERSON,7202430186,1740,276,2016,1440,71.43%
Colorado,2018,G,JEFFERSON,7202430187,1272,97,1369,1100,80.35%
Colorado,2018,G,JEFFERSON,7202430188,1320,181,1501,1013,67.49%
Colorado,2018,G,JEFFERSON,7202430189,1849,165,2014,1514,75.17%
Colorado,2018,G,JEFFERSON,7202430190,1147,133,1280,908,70.94%
Colorado,2018,G,JEFFERSON,7202430191,1882,230,2112,1496,70.83%
Colorado,2018,G,JEFFERSON,7202430192,1695,153,1848,1339,72.46%
Colorado,2018,G,JEFFERSON,7202430193,1514,141,1655,1282,77.46%
Colorado,2018,G,JEFFERSON,7202430194,2105,316,2421,1583,65.39%
Colorado,2018,G,JEFFERSON,7202430195,1992,417,2409,1320,54.79%
Colorado,2018,G,JEFFERSON,7202430196,1487,163,1650,1234,74.79%
Colorado,2018,G,JEFFERSON,7202430197,1160,150,1310,909,69.39%
Colorado,2018,G,JEFFERSON,7202430198,2035,542,2577,1370,53.16%
Colorado,2018,G,JEFFERSON,7202430199,1240,87,1327,1039,78.30%
Colorado,2018,G,JEFFERSON,7202430200,1944,238,2182,1448,66.36%
Colorado,2018,G,JEFFERSON,7202430201,1727,165,1892,1394,73.68%
Colorado,2018,G,JEFFERSON,7202530202,1271,82,1353,1144,84.55%
Colorado,2018,G,JEFFERSON,7202530203,511,78,589,387,65.70%
Colorado,2018,G,JEFFERSON,7202530204,1502,111,1613,1251,77.56%
Colorado,2018,G,JEFFERSON,7202730205,1709,102,1811,1473,81.34%
Colorado,2018,G,JEFFERSON,7202730206,1382,80,1462,1174,80.30%
Colorado,2018,G,JEFFERSON,7202730207,1635,121,1756,1415,80.58%
Colorado,2018,G,JEFFERSON,7202730208,1719,99,1818,1537,84.54%
Colorado,2018,G,JEFFERSON,7202730209,1688,127,1815,1374,75.70%
Colorado,2018,G,JEFFERSON,7202730210,2404,124,2528,2065,81.69%
Colorado,2018,G,JEFFERSON,7202730211,4736,136,4872,4039,82.90%
Colorado,2018,G,JEFFERSON,7202830212,1609,81,1690,1377,81.48%
Colorado,2018,G,JEFFERSON,7202830213,1357,87,1444,1148,79.50%
Colorado,2018,G,JEFFERSON,7202830214,1848,121,1969,1570,79.74%
Colorado,2018,G,JEFFERSON,7202830215,2469,107,2576,2142,83.15%
Colorado,2018,G,JEFFERSON,7202830216,1579,436,2015,1168,57.97%
Colorado,2018,G,JEFFERSON,7202830217,1163,234,1397,914,65.43%
Colorado,2018,G,JEFFERSON,7222230218,2077,151,2228,1776,79.71%
Colorado,2018,G,JEFFERSON,7222230219,885,57,942,708,75.16%
Colorado,2018,G,JEFFERSON,7222330220,1194,259,1453,864,59.46%
Colorado,2018,G,JEFFERSON,7222330221,1808,144,1952,1522,77.97%
Colorado,2018,G,JEFFERSON,7222330222,1285,269,1554,888,57.14%
Colorado,2018,G,JEFFERSON,7222330223,1533,113,1646,1240,75.33%
Colorado,2018,G,JEFFERSON,7222330224,1570,464,2034,968,47.59%
Colorado,2018,G,JEFFERSON,7222330225,1315,311,1626,924,56.83%
Colorado,2018,G,JEFFERSON,7222330226,2372,483,2855,1552,54.36%
Colorado,2018,G,JEFFERSON,7222330227,1907,527,2434,1250,51.36%
Colorado,2018,G,JEFFERSON,7222330228,2033,172,2205,1689,76.60%
Colorado,2018,G,JEFFERSON,7222330229,1658,401,2059,1299,63.09%
Colorado,2018,G,JEFFERSON,7222430230,1332,194,1526,989,64.81%
Colorado,2018,G,JEFFERSON,7222430231,1593,330,1923,1154,60.01%
Colorado,2018,G,JEFFERSON,7222830232,1954,365,2319,1383,59.64%
Colorado,2018,G,JEFFERSON,7222830233,1331,117,1448,1073,74.10%
Colorado,2018,G,JEFFERSON,7222830234,1229,126,1355,959,70.77%
Colorado,2018,G,JEFFERSON,7222830235,1558,115,1673,1276,76.27%
Colorado,2018,G,JEFFERSON,7222830236,1500,103,1603,1287,80.29%
Colorado,2018,G,JEFFERSON,7222830237,1353,342,1695,967,57.05%
Colorado,2018,G,JEFFERSON,7222830238,1507,395,1902,1014,53.31%
Colorado,2018,G,JEFFERSON,7222830239,1304,236,1540,952,61.82%
Colorado,2018,G,JEFFERSON,7222830240,1623,285,1908,1180,61.84%
Colorado,2018,G,JEFFERSON,7222830241,1444,229,1673,922,55.11%
Colorado,2018,G,JEFFERSON,7222830242,1435,201,1636,1026,62.71%
Colorado,2018,G,JEFFERSON,7222830243,1355,112,1467,1089,74.23%
Colorado,2018,G,JEFFERSON,7222830244,1386,152,1538,1038,67.49%
Colorado,2018,G,JEFFERSON,7222830245,1817,218,2035,1248,61.33%
Colorado,2018,G,JEFFERSON,7222830246,1016,82,1098,819,74.59%
Colorado,2018,G,JEFFERSON,7222830247,1672,257,1929,1098,56.92%
Colorado,2018,G,JEFFERSON,7222830248,1423,293,1716,947,55.19%
Colorado,2018,G,JEFFERSON,7222830249,1919,729,2648,1354,51.13%
Colorado,2018,G,JEFFERSON,7222830250,1410,168,1578,1083,68.63%
Colorado,2018,G,JEFFERSON,7222830251,1937,369,2306,1377,59.71%
Colorado,2018,G,JEFFERSON,7222830252,1864,175,2039,1460,71.60%
Colorado,2018,G,JEFFERSON,7222830253,1184,194,1378,861,62.48%
Colorado,2018,G,JEFFERSON,7222830254,1724,148,1872,1408,75.21%
Colorado,2018,G,JEFFERSON,7222830255,1370,167,1537,986,64.15%
Colorado,2018,G,JEFFERSON,7222830256,1977,233,2210,1504,68.05%
Colorado,2018,G,JEFFERSON,7222830257,1850,262,2112,1430,67.71%
Colorado,2018,G,JEFFERSON,7222830258,1436,230,1666,1064,63.87%
Colorado,2018,G,KIOWA,4356431001,192,18,210,136,64.76%
Colorado,2018,G,KIOWA,4356431002,286,22,308,246,79.87%
Colorado,2018,G,KIOWA,4356431003,392,40,432,340,78.70%
Colorado,2018,G,KIOWA,4356431004,83,7,90,76,84.44%
Colorado,2018,G,KIT CARSON,4016532001,421,78,499,278,55.71%
Colorado,2018,G,KIT CARSON,4016532002,311,73,384,207,53.91%
Colorado,2018,G,KIT CARSON,4016532003,452,103,555,301,54.23%
Colorado,2018,G,KIT CARSON,4016532004,350,46,396,278,70.20%
Colorado,2018,G,KIT CARSON,4016532005,499,84,583,372,63.81%
Colorado,2018,G,KIT CARSON,4016532006,366,36,402,260,64.68%
Colorado,2018,G,KIT CARSON,4016532007,328,21,349,261,74.79%
Colorado,2018,G,KIT CARSON,4016532008,289,52,341,218,63.93%
Colorado,2018,G,KIT CARSON,4016532009,394,44,438,283,64.61%
Colorado,2018,G,KIT CARSON,4016532010,168,21,189,117,61.90%
Colorado,2018,G,KIT CARSON,4016532011,251,35,286,196,68.53%
Colorado,2018,G,KIT CARSON,4016532012,250,37,287,179,62.37%
Colorado,2018,G,KIT CARSON,4016532013,295,40,335,213,63.58%
Colorado,2018,G,LA PLATA,3065934001,1024,343,1367,734,53.69%
Colorado,2018,G,LA PLATA,3065934002,1142,364,1506,862,57.24%
Colorado,2018,G,LA PLATA,3065934003,1377,247,1624,1121,69.03%
Colorado,2018,G,LA PLATA,3065934004,1547,350,1897,1256,66.21%
Colorado,2018,G,LA PLATA,3065934005,1449,280,1729,1156,66.86%
Colorado,2018,G,LA PLATA,3065934006,568,79,647,486,75.12%
Colorado,2018,G,LA PLATA,3065934007,1262,400,1662,939,56.50%
Colorado,2018,G,LA PLATA,3065934008,1531,448,1979,1145,57.86%
Colorado,2018,G,LA PLATA,3065934009,336,196,532,186,34.96%
Colorado,2018,G,LA PLATA,3065934010,792,143,935,694,74.22%
Colorado,2018,G,LA PLATA,3065934011,1535,216,1751,1157,66.08%
Colorado,2018,G,LA PLATA,3065934012,1583,249,1832,1187,64.79%
Colorado,2018,G,LA PLATA,3065934013,1458,297,1755,1149,65.47%
Colorado,2018,G,LA PLATA,3065934014,1162,173,1335,928,69.51%
Colorado,2018,G,LA PLATA,3065934015,730,177,907,579,63.84%
Colorado,2018,G,LA PLATA,3065934016,1473,268,1741,1152,66.17%
Colorado,2018,G,LA PLATA,3065934017,1457,309,1766,1132,64.10%
Colorado,2018,G,LA PLATA,3065934018,971,165,1136,765,67.34%
Colorado,2018,G,LA PLATA,3065934019,1374,230,1604,1114,69.45%
Colorado,2018,G,LA PLATA,3065934020,1627,394,2021,1233,61.01%
Colorado,2018,G,LA PLATA,3065934021,1058,177,1235,790,63.97%
Colorado,2018,G,LA PLATA,3065934022,1134,229,1363,846,62.07%
Colorado,2018,G,LA PLATA,3065934023,1355,231,1586,954,60.15%
Colorado,2018,G,LA PLATA,3065934024,445,104,549,295,53.73%
Colorado,2018,G,LA PLATA,3065934025,1221,154,1375,798,58.04%
Colorado,2018,G,LA PLATA,3065934026,1168,287,1455,912,62.68%
Colorado,2018,G,LA PLATA,3065934027,304,91,395,235,59.49%
Colorado,2018,G,LA PLATA,3065934028,1417,321,1738,1126,64.79%
Colorado,2018,G,LA PLATA,3065934029,1324,211,1535,1090,71.01%
Colorado,2018,G,LA PLATA,3065934030,1659,910,2569,1206,46.94%
Colorado,2018,G,LA PLATA,3065934031,598,117,715,457,63.92%
Colorado,2018,G,LA PLATA,3065934032,1584,248,1832,1217,66.43%
Colorado,2018,G,LAKE,3056133001,758,148,906,507,55.96%
Colorado,2018,G,LAKE,3056133002,464,121,585,288,49.23%
Colorado,2018,G,LAKE,3056133003,886,232,1118,606,54.20%
Colorado,2018,G,LAKE,3056133004,802,178,980,552,56.33%
Colorado,2018,G,LAKE,3056133005,669,139,808,470,58.17%
Colorado,2018,G,LAKE,3056133006,780,190,970,536,55.26%
Colorado,2018,G,LARIMER,2145235201,987,316,1303,609,46.74%
Colorado,2018,G,LARIMER,2145235202,1379,207,1586,1031,65.01%
Colorado,2018,G,LARIMER,2145235203,1310,163,1473,1014,68.84%
Colorado,2018,G,LARIMER,2145235204,1534,251,1785,1092,61.18%
Colorado,2018,G,LARIMER,2145235205,1258,328,1586,980,61.79%
Colorado,2018,G,LARIMER,2145235206,1570,264,1834,1287,70.17%
Colorado,2018,G,LARIMER,2145235207,1201,292,1493,963,64.50%
Colorado,2018,G,LARIMER,2145235208,1414,327,1741,1147,65.88%
Colorado,2018,G,LARIMER,2145235209,1415,232,1647,1160,70.43%
Colorado,2018,G,LARIMER,2145235210,1244,310,1554,900,57.92%
Colorado,2018,G,LARIMER,2145235211,1244,260,1504,958,63.70%
Colorado,2018,G,LARIMER,2145235212,1080,92,1172,920,78.50%
Colorado,2018,G,LARIMER,2145235213,988,210,1198,770,64.27%
Colorado,2018,G,LARIMER,2145235214,1315,204,1519,1056,69.52%
Colorado,2018,G,LARIMER,2145235215,1042,165,1207,771,63.88%
Colorado,2018,G,LARIMER,2145235216,914,195,1109,705,63.57%
Colorado,2018,G,LARIMER,2145235217,1477,172,1649,1214,73.62%
Colorado,2018,G,LARIMER,2145235218,1313,216,1529,1024,66.97%
Colorado,2018,G,LARIMER,2145235219,1550,153,1703,1277,74.99%
Colorado,2018,G,LARIMER,2145235220,1230,101,1331,1053,79.11%
Colorado,2018,G,LARIMER,2145235221,1477,268,1745,1089,62.41%
Colorado,2018,G,LARIMER,2145235222,801,59,860,691,80.35%
Colorado,2018,G,LARIMER,2145235223,1374,206,1580,1092,69.11%
Colorado,2018,G,LARIMER,2145235224,1027,137,1164,789,67.78%
Colorado,2018,G,LARIMER,2145235225,1566,82,1648,1316,79.85%
Colorado,2018,G,LARIMER,2145235226,1257,153,1410,834,59.15%
Colorado,2018,G,LARIMER,2145235227,943,89,1032,766,74.22%
Colorado,2018,G,LARIMER,2145235228,1300,107,1407,1067,75.84%
Colorado,2018,G,LARIMER,2145235229,1613,191,1804,1249,69.24%
Colorado,2018,G,LARIMER,2145235230,1310,83,1393,1055,75.74%
Colorado,2018,G,LARIMER,2145235231,1166,178,1344,917,68.23%
Colorado,2018,G,LARIMER,2145235232,1195,92,1287,985,76.53%
Colorado,2018,G,LARIMER,2145235233,1256,138,1394,1013,72.67%
Colorado,2018,G,LARIMER,2145235234,1465,100,1565,1187,75.85%
Colorado,2018,G,LARIMER,2145235235,1792,155,1947,1441,74.01%
Colorado,2018,G,LARIMER,2145235236,885,46,931,768,82.49%
Colorado,2018,G,LARIMER,2145235237,1340,113,1453,1112,76.53%
Colorado,2018,G,LARIMER,2145235238,1074,111,1185,894,75.44%
Colorado,2018,G,LARIMER,2145235239,1684,221,1905,1132,59.42%
Colorado,2018,G,LARIMER,2145235240,1488,164,1652,1126,68.16%
Colorado,2018,G,LARIMER,2145235241,1095,133,1228,900,73.29%
Colorado,2018,G,LARIMER,2145235242,942,207,1149,650,56.57%
Colorado,2018,G,LARIMER,2145235243,979,93,1072,838,78.17%
Colorado,2018,G,LARIMER,2145235244,790,120,910,653,71.76%
Colorado,2018,G,LARIMER,2145235245,883,118,1001,691,69.03%
Colorado,2018,G,LARIMER,2145235246,990,252,1242,687,55.31%
Colorado,2018,G,LARIMER,2145235247,657,133,790,485,61.39%
Colorado,2018,G,LARIMER,2145335301,1097,238,1335,859,64.34%
Colorado,2018,G,LARIMER,2145335302,1690,239,1929,1432,74.24%
Colorado,2018,G,LARIMER,2145335303,1322,208,1530,1069,69.87%
Colorado,2018,G,LARIMER,2145335304,947,252,1199,691,57.63%
Colorado,2018,G,LARIMER,2145335305,1456,341,1797,1113,61.94%
Colorado,2018,G,LARIMER,2145335306,805,337,1142,561,49.12%
Colorado,2018,G,LARIMER,2145335307,887,309,1196,591,49.41%
Colorado,2018,G,LARIMER,2145335308,1051,374,1425,623,43.72%
Colorado,2018,G,LARIMER,2145335309,1031,717,1748,715,40.90%
Colorado,2018,G,LARIMER,2145335310,889,181,1070,709,66.26%
Colorado,2018,G,LARIMER,2145335311,868,228,1096,683,62.32%
Colorado,2018,G,LARIMER,2145335312,1465,383,1848,1093,59.15%
Colorado,2018,G,LARIMER,2145335313,1345,208,1553,1074,69.16%
Colorado,2018,G,LARIMER,2145335314,1109,147,1256,915,72.85%
Colorado,2018,G,LARIMER,2145335315,1475,201,1676,1179,70.35%
Colorado,2018,G,LARIMER,2145335316,988,107,1095,832,75.98%
Colorado,2018,G,LARIMER,2145335317,1438,74,1512,1233,81.55%
Colorado,2018,G,LARIMER,2145335318,1320,280,1600,980,61.25%
Colorado,2018,G,LARIMER,2145335319,1194,150,1344,938,69.79%
Colorado,2018,G,LARIMER,2145335320,1075,175,1250,824,65.92%
Colorado,2018,G,LARIMER,2145335321,1219,349,1568,864,55.10%
Colorado,2018,G,LARIMER,2145335322,1332,196,1528,1050,68.72%
Colorado,2018,G,LARIMER,2145335323,1343,143,1486,1046,70.39%
Colorado,2018,G,LARIMER,2145335324,1625,93,1718,1405,81.78%
Colorado,2018,G,LARIMER,2145335325,1605,237,1842,1253,68.02%
Colorado,2018,G,LARIMER,2145335326,924,109,1033,698,67.57%
Colorado,2018,G,LARIMER,2145335327,1455,93,1548,1208,78.04%
Colorado,2018,G,LARIMER,2145335328,1516,100,1616,1278,79.08%
Colorado,2018,G,LARIMER,2145335329,1166,87,1253,981,78.29%
Colorado,2018,G,LARIMER,2145335330,1356,111,1467,1113,75.87%
Colorado,2018,G,LARIMER,2145335331,878,94,972,646,66.46%
Colorado,2018,G,LARIMER,2145335332,1182,162,1344,869,64.66%
Colorado,2018,G,LARIMER,2145335333,961,120,1081,782,72.34%
Colorado,2018,G,LARIMER,2145335334,1189,583,1772,851,48.02%
Colorado,2018,G,LARIMER,2145335335,650,412,1062,471,44.35%
Colorado,2018,G,LARIMER,2145335336,993,352,1345,678,50.41%
Colorado,2018,G,LARIMER,2145335337,1045,303,1348,732,54.30%
Colorado,2018,G,LARIMER,2145335338,1032,485,1517,708,46.67%
Colorado,2018,G,LARIMER,2145335339,878,227,1105,638,57.74%
Colorado,2018,G,LARIMER,2145335340,867,115,982,665,67.72%
Colorado,2018,G,LARIMER,2145335341,808,200,1008,604,59.92%
Colorado,2018,G,LARIMER,2145335342,763,132,895,601,67.15%
Colorado,2018,G,LARIMER,2145335343,876,275,1151,611,53.08%
Colorado,2018,G,LARIMER,2145335344,861,224,1085,622,57.33%
Colorado,2018,G,LARIMER,2154935401,722,109,831,573,68.95%
Colorado,2018,G,LARIMER,2154935402,836,76,912,676,74.12%
Colorado,2018,G,LARIMER,2154935403,1313,113,1426,982,68.86%
Colorado,2018,G,LARIMER,2154935404,107,22,129,75,58.14%
Colorado,2018,G,LARIMER,2154935405,758,75,833,615,73.83%
Colorado,2018,G,LARIMER,2154935406,934,74,1008,786,77.98%
Colorado,2018,G,LARIMER,2154935407,797,80,877,632,72.06%
Colorado,2018,G,LARIMER,2154935408,907,107,1014,730,71.99%
Colorado,2018,G,LARIMER,2154935409,1240,114,1354,1026,75.78%
Colorado,2018,G,LARIMER,2154935410,1028,135,1163,798,68.62%
Colorado,2018,G,LARIMER,2154935411,1424,142,1566,1183,75.54%
Colorado,2018,G,LARIMER,2154935412,908,160,1068,725,67.88%
Colorado,2018,G,LARIMER,2154935413,1278,178,1456,1059,72.73%
Colorado,2018,G,LARIMER,2154935414,1190,163,1353,960,70.95%
Colorado,2018,G,LARIMER,2154935415,1313,238,1551,1038,66.92%
Colorado,2018,G,LARIMER,2154935416,1357,127,1484,1132,76.28%
Colorado,2018,G,LARIMER,2154935417,1176,79,1255,1005,80.08%
Colorado,2018,G,LARIMER,2154935418,1600,130,1730,1331,76.94%
Colorado,2018,G,LARIMER,2154935419,2269,154,2423,1762,72.72%
Colorado,2018,G,LARIMER,2154935420,1091,113,1204,850,70.60%
Colorado,2018,G,LARIMER,2154935421,976,72,1048,799,76.24%
Colorado,2018,G,LARIMER,2154935422,1547,98,1645,1280,77.81%
Colorado,2018,G,LARIMER,2154935423,1468,95,1563,1263,80.81%
Colorado,2018,G,LARIMER,2154935424,41,2,43,33,76.74%
Colorado,2018,G,LARIMER,2154935425,172,14,186,144,77.42%
Colorado,2018,G,LARIMER,2154935426,1108,63,1171,929,79.33%
Colorado,2018,G,LARIMER,2154935427,1368,99,1467,1169,79.69%
Colorado,2018,G,LARIMER,2154935428,1239,107,1346,1015,75.41%
Colorado,2018,G,LARIMER,2154935429,1022,88,1110,809,72.88%
Colorado,2018,G,LARIMER,2154935430,975,76,1051,811,77.16%
Colorado,2018,G,LARIMER,2154935431,1288,147,1435,974,67.87%
Colorado,2018,G,LARIMER,2154935432,1644,249,1893,1249,65.98%
Colorado,2018,G,LARIMER,2154935433,1416,188,1604,1053,65.65%
Colorado,2018,G,LARIMER,2154935434,1112,123,1235,843,68.26%
Colorado,2018,G,LARIMER,2154935435,1068,94,1162,837,72.03%
Colorado,2018,G,LARIMER,2154935436,890,61,951,697,73.29%
Colorado,2018,G,LARIMER,2154935437,954,67,1021,809,79.24%
Colorado,2018,G,LARIMER,2154935438,1017,108,1125,835,74.22%
Colorado,2018,G,LARIMER,2154935439,758,107,865,588,67.98%
Colorado,2018,G,LARIMER,2154935440,844,95,939,635,67.63%
Colorado,2018,G,LARIMER,2154935441,924,70,994,767,77.16%
Colorado,2018,G,LARIMER,2155135501,964,96,1060,704,66.42%
Colorado,2018,G,LARIMER,2155135502,1274,74,1348,1030,76.41%
Colorado,2018,G,LARIMER,2155135503,1377,181,1558,1052,67.52%
Colorado,2018,G,LARIMER,2155135504,1426,170,1596,1005,62.97%
Colorado,2018,G,LARIMER,2155135505,1250,205,1455,818,56.22%
Colorado,2018,G,LARIMER,2155135506,1163,152,1315,860,65.40%
Colorado,2018,G,LARIMER,2155135507,1666,126,1792,1390,77.57%
Colorado,2018,G,LARIMER,2155135508,999,104,1103,807,73.16%
Colorado,2018,G,LARIMER,2155135509,863,120,983,654,66.53%
Colorado,2018,G,LARIMER,2155135510,1294,122,1416,1033,72.95%
Colorado,2018,G,LARIMER,2155135511,915,46,961,762,79.29%
Colorado,2018,G,LARIMER,2155135512,1451,160,1611,1126,69.89%
Colorado,2018,G,LARIMER,2155135513,1184,112,1296,891,68.75%
Colorado,2018,G,LARIMER,2155135514,1447,194,1641,1039,63.32%
Colorado,2018,G,LARIMER,2155135515,1245,121,1366,957,70.06%
Colorado,2018,G,LARIMER,2155135516,1564,90,1654,1349,81.56%
Colorado,2018,G,LARIMER,2155135517,1280,121,1401,1075,76.73%
Colorado,2018,G,LARIMER,2155135518,1585,248,1833,1159,63.23%
Colorado,2018,G,LARIMER,2155135519,1329,162,1491,1002,67.20%
Colorado,2018,G,LARIMER,2155135520,1462,220,1682,1091,64.86%
Colorado,2018,G,LARIMER,2155135521,1247,120,1367,989,72.35%
Colorado,2018,G,LARIMER,2155135522,1643,141,1784,1369,76.74%
Colorado,2018,G,LARIMER,2155135523,1112,83,1195,916,76.65%
Colorado,2018,G,LARIMER,2155135524,1265,184,1449,941,64.94%
Colorado,2018,G,LARIMER,2155135525,765,34,799,679,84.98%
Colorado,2018,G,LARIMER,2155135526,1451,118,1569,1199,76.42%
Colorado,2018,G,LARIMER,2155135527,1336,183,1519,1016,66.89%
Colorado,2018,G,LARIMER,2155135528,1627,199,1826,1229,67.31%
Colorado,2018,G,LARIMER,2155135529,930,192,1122,685,61.05%
Colorado,2018,G,LARIMER,2155135530,1521,261,1782,1113,62.46%
Colorado,2018,G,LARIMER,2155135531,944,68,1012,792,78.26%
Colorado,2018,G,LARIMER,2155135532,1430,225,1655,1030,62.24%
Colorado,2018,G,LARIMER,2155135533,1043,202,1245,756,60.72%
Colorado,2018,G,LARIMER,2155135534,816,136,952,551,57.88%
Colorado,2018,G,LARIMER,2155135535,1564,217,1781,1114,62.55%
Colorado,2018,G,LARIMER,2155135536,1653,104,1757,1378,78.43%
Colorado,2018,G,LARIMER,2155135537,1593,101,1694,1327,78.34%
Colorado,2018,G,LARIMER,2155135538,1473,77,1550,1242,80.13%
Colorado,2018,G,LARIMER,2155135539,1387,108,1495,1108,74.11%
Colorado,2018,G,LARIMER,2155135540,732,98,830,507,61.08%
Colorado,2018,G,LARIMER,2155135541,1608,129,1737,1268,73.00%
Colorado,2018,G,LARIMER,2155135542,1334,377,1711,951,55.58%
Colorado,2018,G,LARIMER,2155135543,766,94,860,576,66.98%
Colorado,2018,G,LARIMER,2155135544,874,185,1059,656,61.95%
Colorado,2018,G,LARIMER,2155135545,975,133,1108,715,64.53%
Colorado,2018,G,LARIMER,2155135546,773,137,910,574,63.08%
Colorado,2018,G,LARIMER,2155135547,933,165,1098,633,57.65%
Colorado,2018,G,LARIMER,2155135548,672,128,800,509,63.63%
Colorado,2018,G,LARIMER,2155135549,722,51,773,537,69.47%
Colorado,2018,G,LARIMER,2155235601,483,71,554,310,55.96%
Colorado,2018,G,LARIMER,2155235602,924,51,975,801,82.15%
Colorado,2018,G,LARIMER,2155235603,1430,99,1529,1259,82.34%
Colorado,2018,G,LARIMER,2155335701,1313,149,1462,1038,71.00%
Colorado,2018,G,LARIMER,2155335702,1097,73,1170,892,76.24%
Colorado,2018,G,LARIMER,2155335703,1159,174,1333,702,52.66%
Colorado,2018,G,LARIMER,2234935801,1089,105,1194,795,66.58%
Colorado,2018,G,LARIMER,2234935802,801,58,859,688,80.09%
Colorado,2018,G,LARIMER,2234935803,1520,92,1612,1285,79.71%
Colorado,2018,G,LARIMER,2234935804,832,40,872,667,76.49%
Colorado,2018,G,LARIMER,2234935805,715,46,761,598,78.58%
Colorado,2018,G,LARIMER,2234935806,918,62,980,805,82.14%
Colorado,2018,G,LARIMER,2234935807,767,43,810,644,79.51%
Colorado,2018,G,LARIMER,2234935808,1318,60,1378,1166,84.62%
Colorado,2018,G,LARIMER,2234935809,1102,75,1177,929,78.93%
Colorado,2018,G,LARIMER,2234935810,1035,111,1146,788,68.76%
Colorado,2018,G,LARIMER,2234935811,1283,192,1475,998,67.66%
Colorado,2018,G,LARIMER,2234935812,990,67,1057,835,79.00%
Colorado,2018,G,LARIMER,2234935813,971,73,1044,849,81.32%
Colorado,2018,G,LARIMER,2234935814,874,43,917,703,76.66%
Colorado,2018,G,LARIMER,2235235101,919,145,1064,656,61.65%
Colorado,2018,G,LARIMER,2235235102,239,10,249,206,82.73%
Colorado,2018,G,LAS ANIMAS,4356436001,196,40,236,158,66.95%
Colorado,2018,G,LAS ANIMAS,4356436002,94,23,117,74,63.25%
Colorado,2018,G,LAS ANIMAS,4356436003,713,130,843,566,67.14%
Colorado,2018,G,LAS ANIMAS,4356436004,639,117,756,452,59.79%
Colorado,2018,G,LAS ANIMAS,4356436005,438,103,541,322,59.52%
Colorado,2018,G,LAS ANIMAS,4356436006,430,105,535,329,61.50%
Colorado,2018,G,LAS ANIMAS,4356436007,503,94,597,394,66.00%
Colorado,2018,G,LAS ANIMAS,4356436008,313,72,385,224,58.18%
Colorado,2018,G,LAS ANIMAS,4356436009,505,95,600,404,67.33%
Colorado,2018,G,LAS ANIMAS,4356436010,766,184,950,545,57.37%
Colorado,2018,G,LAS ANIMAS,4356436011,813,251,1064,511,48.03%
Colorado,2018,G,LAS ANIMAS,4356436012,709,254,963,499,51.82%
Colorado,2018,G,LAS ANIMAS,4356436013,534,150,684,382,55.85%
Colorado,2018,G,LAS ANIMAS,4356436014,558,129,687,407,59.24%
Colorado,2018,G,LAS ANIMAS,4356436015,828,171,999,598,59.86%
Colorado,2018,G,LAS ANIMAS,4356436016,806,226,1032,568,55.04%
Colorado,2018,G,LINCOLN,4016437001,218,44,262,182,69.47%
Colorado,2018,G,LINCOLN,4016437002,364,75,439,262,59.68%
Colorado,2018,G,LINCOLN,4016437003,289,53,342,230,67.25%
Colorado,2018,G,LINCOLN,4016437004,191,25,216,150,69.44%
Colorado,2018,G,LINCOLN,4016437005,282,71,353,204,57.79%
Colorado,2018,G,LINCOLN,4016437006,243,38,281,180,64.06%
Colorado,2018,G,LINCOLN,4016437007,369,62,431,275,63.81%
Colorado,2018,G,LINCOLN,4016437008,57,5,62,46,74.19%
Colorado,2018,G,LINCOLN,4016437009,140,21,161,108,67.08%
Colorado,2018,G,LINCOLN,4016437010,162,19,181,141,77.90%
Colorado,2018,G,LINCOLN,4016437011,52,3,55,45,81.82%
Colorado,2018,G,LINCOLN,4016437012,37,4,41,30,73.17%
Colorado,2018,G,LINCOLN,4016437013,366,54,420,272,64.76%
Colorado,2018,G,LOGAN,4016538001,966,213,1179,724,61.41%
Colorado,2018,G,LOGAN,4016538002,866,231,1097,601,54.79%
Colorado,2018,G,LOGAN,4016538003,582,179,761,349,45.86%
Colorado,2018,G,LOGAN,4016538004,891,273,1164,548,47.08%
Colorado,2018,G,LOGAN,4016538005,722,198,920,492,53.48%
Colorado,2018,G,LOGAN,4016538006,659,96,755,542,71.79%
Colorado,2018,G,LOGAN,4016538007,1059,129,1188,866,72.90%
Colorado,2018,G,LOGAN,4016538008,1078,87,1165,922,79.14%
Colorado,2018,G,LOGAN,4016538009,1034,80,1114,908,81.51%
Colorado,2018,G,LOGAN,4016538010,863,69,932,727,78.00%
Colorado,2018,G,LOGAN,4016538011,541,48,589,455,77.25%
Colorado,2018,G,LOGAN,4016538012,345,47,392,293,74.74%
Colorado,2018,G,LOGAN,4016538013,599,57,656,490,74.70%
Colorado,2018,G,LOGAN,4016538014,354,45,399,274,68.67%
Colorado,2018,G,LOGAN,4016538015,481,71,552,387,70.11%
Colorado,2018,G,LOGAN,4016538016,226,20,246,200,81.30%
Colorado,2018,G,MESA,3075439001,1619,296,1915,1174,61.31%
Colorado,2018,G,MESA,3075439002,1612,319,1931,1260,65.25%
Colorado,2018,G,MESA,3075439003,1491,344,1835,1178,64.20%
Colorado,2018,G,MESA,3075439004,2024,591,2615,1466,56.06%
Colorado,2018,G,MESA,3075439005,1470,294,1764,1147,65.02%
Colorado,2018,G,MESA,3075439006,2054,561,2615,1498,57.28%
Colorado,2018,G,MESA,3075439007,1598,512,2110,1153,54.64%
Colorado,2018,G,MESA,3075439008,810,140,950,679,71.47%
Colorado,2018,G,MESA,3075439009,969,136,1105,782,70.77%
Colorado,2018,G,MESA,3075439010,1064,153,1217,784,64.42%
Colorado,2018,G,MESA,3075439011,207,57,264,154,58.33%
Colorado,2018,G,MESA,3075439012,1332,210,1542,1012,65.63%
Colorado,2018,G,MESA,3075439013,1818,579,2397,1158,48.31%
Colorado,2018,G,MESA,3075439014,1312,248,1560,974,62.44%
Colorado,2018,G,MESA,3075439015,1040,126,1166,839,71.96%
Colorado,2018,G,MESA,3075439016,911,179,1090,713,65.41%
Colorado,2018,G,MESA,3075439017,978,309,1287,737,57.26%
Colorado,2018,G,MESA,3075439018,734,298,1032,532,51.55%
Colorado,2018,G,MESA,3075439019,549,173,722,391,54.16%
Colorado,2018,G,MESA,3075439020,1901,462,2363,1417,59.97%
Colorado,2018,G,MESA,3075439021,2002,491,2493,1314,52.71%
Colorado,2018,G,MESA,3075439022,2170,655,2825,1404,49.70%
Colorado,2018,G,MESA,3075439023,1928,820,2748,1149,41.81%
Colorado,2018,G,MESA,3075439024,2260,1035,3295,1269,38.51%
Colorado,2018,G,MESA,3075439025,1971,405,2376,1413,59.47%
Colorado,2018,G,MESA,3075439026,2165,843,3008,1331,44.25%
Colorado,2018,G,MESA,3075439027,2064,370,2434,1502,61.71%
Colorado,2018,G,MESA,3075439028,1540,151,1691,1278,75.58%
Colorado,2018,G,MESA,3075439029,1823,220,2043,1482,72.54%
Colorado,2018,G,MESA,3075539030,2448,768,3216,1710,53.17%
Colorado,2018,G,MESA,3075539031,1336,209,1545,1079,69.84%
Colorado,2018,G,MESA,3075539032,1127,188,1315,908,69.05%
Colorado,2018,G,MESA,3075539033,1837,299,2136,1539,72.05%
Colorado,2018,G,MESA,3075539034,953,147,1100,771,70.09%
Colorado,2018,G,MESA,3075539035,1461,269,1730,1222,70.64%
Colorado,2018,G,MESA,3075539036,1011,115,1126,914,81.17%
Colorado,2018,G,MESA,3075539037,1370,315,1685,1131,67.12%
Colorado,2018,G,MESA,3075539038,2058,479,2537,1506,59.36%
Colorado,2018,G,MESA,3075539039,1976,1030,3006,1399,46.54%
Colorado,2018,G,MESA,3075539040,1694,557,2251,1310,58.20%
Colorado,2018,G,MESA,3075539041,1421,315,1736,1147,66.07%
Colorado,2018,G,MESA,3075539042,1615,218,1833,1376,75.07%
Colorado,2018,G,MESA,3075539043,2057,1032,3089,1430,46.29%
Colorado,2018,G,MESA,3075539044,2077,866,2943,1463,49.71%
Colorado,2018,G,MESA,3075539045,2265,1088,3353,1490,44.44%
Colorado,2018,G,MESA,3075539046,2116,542,2658,1507,56.70%
Colorado,2018,G,MESA,3075539047,1852,309,2161,1525,70.57%
Colorado,2018,G,MESA,3075539048,2008,371,2379,1605,67.47%
Colorado,2018,G,MESA,3075539049,2144,792,2936,1449,49.35%
Colorado,2018,G,MESA,3075539050,1708,456,2164,1253,57.90%
Colorado,2018,G,MESA,3075539051,1668,393,2061,1232,59.78%
Colorado,2018,G,MESA,3075539052,2046,601,2647,1322,49.94%
Colorado,2018,G,MESA,3075539053,2067,586,2653,1309,49.34%
Colorado,2018,G,MESA,3075539054,2597,1060,3657,1563,42.74%
Colorado,2018,G,MESA,3075539055,1699,555,2254,1092,48.45%
Colorado,2018,G,MESA,3075539056,2313,678,2991,1650,55.17%
Colorado,2018,G,MESA,3075539057,2285,385,2670,1670,62.55%
Colorado,2018,G,MINERAL,3356240001,749,103,852,626,73.47%
Colorado,2018,G,MOFFAT,3085741001,1382,431,1813,1036,57.14%
Colorado,2018,G,MOFFAT,3085741002,662,215,877,446,50.86%
Colorado,2018,G,MOFFAT,3085741003,1205,235,1440,901,62.57%
Colorado,2018,G,MOFFAT,3085741004,30,15,45,25,55.56%
Colorado,2018,G,MOFFAT,3085741005,959,296,1255,649,51.71%
Colorado,2018,G,MOFFAT,3085741006,216,60,276,180,65.22%
Colorado,2018,G,MOFFAT,3085741007,769,215,984,525,53.35%
Colorado,2018,G,MOFFAT,3085741008,256,101,357,160,44.82%
Colorado,2018,G,MOFFAT,3085741009,794,275,1069,526,49.20%
Colorado,2018,G,MOFFAT,3085741010,116,12,128,94,73.44%
Colorado,2018,G,MOFFAT,3085741011,594,281,875,411,46.97%
Colorado,2018,G,MOFFAT,3085741012,420,161,581,272,46.82%
Colorado,2018,G,MOFFAT,3085741013,379,152,531,267,50.28%
Colorado,2018,G,MONTEZUMA,3065842001,442,63,505,425,84.16%
Colorado,2018,G,MONTEZUMA,3065842002,2244,471,2715,1716,63.20%
Colorado,2018,G,MONTEZUMA,3065842003,1717,226,1943,1357,69.84%
Colorado,2018,G,MONTEZUMA,3065842004,1883,272,2155,1473,68.35%
Colorado,2018,G,MONTEZUMA,3065842005,1008,154,1162,767,66.01%
Colorado,2018,G,MONTEZUMA,3065842006,709,92,801,162,20.22%
Colorado,2018,G,MONTEZUMA,3065842007,2090,484,2574,1322,51.36%
Colorado,2018,G,MONTEZUMA,3065842008,1447,404,1851,1022,55.21%
Colorado,2018,G,MONTEZUMA,3065842009,1436,569,2005,925,46.13%
Colorado,2018,G,MONTEZUMA,3065842010,1373,266,1639,967,59.00%
Colorado,2018,G,MONTEZUMA,3065842011,2342,513,2855,1782,62.42%
Colorado,2018,G,MONTROSE,3065843001,1141,89,1230,859,69.84%
Colorado,2018,G,MONTROSE,3065843002,1038,89,1127,869,77.11%
Colorado,2018,G,MONTROSE,3065843003,1412,230,1642,958,58.34%
Colorado,2018,G,MONTROSE,3065843004,1217,241,1458,830,56.93%
Colorado,2018,G,MONTROSE,3065843005,729,71,800,552,69.00%
Colorado,2018,G,MONTROSE,3065843006,925,88,1013,762,75.22%
Colorado,2018,G,MONTROSE,3065843007,756,132,888,508,57.21%
Colorado,2018,G,MONTROSE,3065843008,361,51,412,225,54.61%
Colorado,2018,G,MONTROSE,3065843009,1270,198,1468,866,58.99%
Colorado,2018,G,MONTROSE,3065843010,123,14,137,92,67.15%
Colorado,2018,G,MONTROSE,3065843011,167,18,185,146,78.92%
Colorado,2018,G,MONTROSE,3065843012,1122,106,1228,815,66.37%
Colorado,2018,G,MONTROSE,3065843013,1004,107,1111,720,64.81%
Colorado,2018,G,MONTROSE,3065843014,660,94,754,512,67.90%
Colorado,2018,G,MONTROSE,3065843015,18,3,21,14,66.67%
Colorado,2018,G,MONTROSE,3065843016,339,49,388,260,67.01%
Colorado,2018,G,MONTROSE,3065843017,979,114,1093,729,66.70%
Colorado,2018,G,MONTROSE,3065843018,1034,93,1127,868,77.02%
Colorado,2018,G,MONTROSE,3065843019,978,83,1061,782,73.70%
Colorado,2018,G,MONTROSE,3065843020,1363,186,1549,933,60.23%
Colorado,2018,G,MONTROSE,3065843021,1100,96,1196,858,71.74%
Colorado,2018,G,MONTROSE,3065843022,1003,84,1087,807,74.24%
Colorado,2018,G,MONTROSE,3065843023,1256,170,1426,999,70.06%
Colorado,2018,G,MONTROSE,3065843024,1107,126,1233,900,72.99%
Colorado,2018,G,MONTROSE,3065843025,1204,99,1303,984,75.52%
Colorado,2018,G,MONTROSE,3065843026,1025,67,1092,856,78.39%
Colorado,2018,G,MONTROSE,3065843027,1059,130,1189,703,59.13%
Colorado,2018,G,MONTROSE,3065843028,1219,138,1357,857,63.15%
Colorado,2018,G,MORGAN,4016544001,1735,143,1878,1390,74.01%
Colorado,2018,G,MORGAN,4016544002,694,55,749,531,70.89%
Colorado,2018,G,MORGAN,4016544003,946,93,1039,621,59.77%
Colorado,2018,G,MORGAN,4016544004,907,114,1021,727,71.20%
Colorado,2018,G,MORGAN,4016544005,950,100,1050,673,64.10%
Colorado,2018,G,MORGAN,4016544006,1106,129,1235,701,56.76%
Colorado,2018,G,MORGAN,4016544007,798,136,934,476,50.96%
Colorado,2018,G,MORGAN,4016544008,773,152,925,469,50.70%
Colorado,2018,G,MORGAN,4016544009,913,135,1048,593,56.58%
Colorado,2018,G,MORGAN,4016544010,942,116,1058,683,64.56%
Colorado,2018,G,MORGAN,4016544011,1047,75,1122,896,79.86%
Colorado,2018,G,MORGAN,4016544012,277,19,296,222,75.00%
Colorado,2018,G,MORGAN,4016544013,482,62,544,358,65.81%
Colorado,2018,G,MORGAN,4016544014,751,95,846,533,63.00%
Colorado,2018,G,MORGAN,4016544015,813,114,927,555,59.87%
Colorado,2018,G,MORGAN,4016544016,958,104,1062,635,59.79%
Colorado,2018,G,MORGAN,4016544017,1106,111,1217,847,69.60%
Colorado,2018,G,OTERO,4354745001,929,113,1042,697,66.89%
Colorado,2018,G,OTERO,4354745002,538,87,625,381,60.96%
Colorado,2018,G,OTERO,4354745003,859,90,949,669,70.50%
Colorado,2018,G,OTERO,4354745004,600,63,663,448,67.57%
Colorado,2018,G,OTERO,4354745005,597,116,713,340,47.69%
Colorado,2018,G,OTERO,4354745006,472,51,523,365,69.79%
Colorado,2018,G,OTERO,4354745007,507,100,607,327,53.87%
Colorado,2018,G,OTERO,4354745008,622,78,700,409,58.43%
Colorado,2018,G,OTERO,4354745009,646,105,751,447,59.52%
Colorado,2018,G,OTERO,4354745010,532,89,621,323,52.01%
Colorado,2018,G,OTERO,4354745011,700,45,745,530,71.14%
Colorado,2018,G,OTERO,4354745012,798,101,899,532,59.18%
Colorado,2018,G,OTERO,4354745013,706,130,836,360,43.06%
Colorado,2018,G,OTERO,4354745014,815,91,906,548,60.49%
Colorado,2018,G,OTERO,4354745015,543,71,614,438,71.34%
Colorado,2018,G,OTERO,4354745016,742,78,820,534,65.12%
Colorado,2018,G,OTERO,4354745017,353,75,428,240,56.07%
Colorado,2018,G,OURAY,3065946001,489,87,576,403,69.97%
Colorado,2018,G,OURAY,3065946002,694,139,833,539,64.71%
Colorado,2018,G,OURAY,3065946003,1226,192,1418,1046,73.77%
Colorado,2018,G,OURAY,3065946004,570,92,662,463,69.94%
Colorado,2018,G,OURAY,3065946005,961,211,1172,803,68.52%
Colorado,2018,G,PARK,2026047008,853,125,978,615,62.88%
Colorado,2018,G,PARK,2026047010,1287,228,1515,940,62.05%
Colorado,2018,G,PARK,2026047011,927,125,1052,731,69.49%
Colorado,2018,G,PARK,2026047012,1739,254,1993,1299,65.18%
Colorado,2018,G,PARK,2026047013,1513,158,1671,1176,70.38%
Colorado,2018,G,PARK,5026047001,1579,400,1979,1169,59.07%
Colorado,2018,G,PARK,5026047002,807,175,982,540,54.99%
Colorado,2018,G,PARK,5026047003,905,145,1050,697,66.38%
Colorado,2018,G,PARK,5026047004,289,47,336,221,65.77%
Colorado,2018,G,PARK,5026047005,597,72,669,469,70.10%
Colorado,2018,G,PARK,5026047006,799,109,908,613,67.51%
Colorado,2018,G,PARK,5026047007,941,149,1090,693,63.58%
Colorado,2018,G,PARK,5026047009,658,97,755,491,65.03%
Colorado,2018,G,PHILLIPS,4016548001,439,77,516,347,67.25%
Colorado,2018,G,PHILLIPS,4016548002,106,26,132,81,61.36%
Colorado,2018,G,PHILLIPS,4016548003,324,96,420,233,55.48%
Colorado,2018,G,PHILLIPS,4016548004,549,117,666,436,65.47%
Colorado,2018,G,PHILLIPS,4016548005,213,20,233,175,75.11%
Colorado,2018,G,PHILLIPS,4016548006,385,70,455,307,67.47%
Colorado,2018,G,PHILLIPS,4016548007,447,82,529,355,67.11%
Colorado,2018,G,PHILLIPS,4016548008,227,80,307,170,55.37%
Colorado,2018,G,PITKIN,3056149001,1307,250,1557,1032,66.28%
Colorado,2018,G,PITKIN,3056149002,1226,424,1650,917,55.58%
Colorado,2018,G,PITKIN,3056149003,1120,236,1356,883,65.12%
Colorado,2018,G,PITKIN,3056149004,1176,269,1445,904,62.56%
Colorado,2018,G,PITKIN,3056149005,1122,272,1394,884,63.41%
Colorado,2018,G,PITKIN,3056149006,1953,419,2372,1478,62.31%
Colorado,2018,G,PITKIN,3056149007,2076,396,2472,1662,67.23%
Colorado,2018,G,PITKIN,3056149008,812,134,946,633,66.91%
Colorado,2018,G,PITKIN,3056149009,1202,270,1472,970,65.90%
Colorado,2018,G,PITKIN,3056149010,756,115,871,611,70.15%
Colorado,2018,G,PROWERS,4356450001,411,113,524,249,47.52%
Colorado,2018,G,PROWERS,4356450002,400,63,463,240,51.84%
Colorado,2018,G,PROWERS,4356450003,417,35,452,251,55.53%
Colorado,2018,G,PROWERS,4356450004,403,89,492,259,52.64%
Colorado,2018,G,PROWERS,4356450005,505,147,652,262,40.18%
Colorado,2018,G,PROWERS,4356450006,426,50,476,341,71.64%
Colorado,2018,G,PROWERS,4356450007,523,67,590,376,63.73%
Colorado,2018,G,PROWERS,4356450008,623,132,755,433,57.35%
Colorado,2018,G,PROWERS,4356450009,362,97,459,223,48.58%
Colorado,2018,G,PROWERS,4356450010,793,148,941,621,65.99%
Colorado,2018,G,PROWERS,4356450011,526,104,630,349,55.40%
Colorado,2018,G,PROWERS,4356450012,472,90,562,348,61.92%
Colorado,2018,G,PROWERS,4356450013,403,50,453,302,66.67%
Colorado,2018,G,PUEBLO,3034651020,195,25,220,112,50.91%
Colorado,2018,G,PUEBLO,3034651021,767,129,896,378,42.19%
Colorado,2018,G,PUEBLO,3034651036,676,48,724,501,69.20%
Colorado,2018,G,PUEBLO,3034651037,619,45,664,496,74.70%
Colorado,2018,G,PUEBLO,3034651038,741,145,886,508,57.34%
Colorado,2018,G,PUEBLO,3034651039,393,83,476,216,45.38%
Colorado,2018,G,PUEBLO,3034651040,432,40,472,337,71.40%
Colorado,2018,G,PUEBLO,3034651041,462,77,539,323,59.93%
Colorado,2018,G,PUEBLO,3034651042,425,254,679,266,39.18%
Colorado,2018,G,PUEBLO,3034651043,452,89,541,268,49.54%
Colorado,2018,G,PUEBLO,3034651044,478,103,581,283,48.71%
Colorado,2018,G,PUEBLO,3034651048,537,117,654,256,39.14%
Colorado,2018,G,PUEBLO,3034651049,422,61,483,260,53.83%
Colorado,2018,G,PUEBLO,3034651050,870,175,1045,425,40.67%
Colorado,2018,G,PUEBLO,3034651051,936,163,1099,577,52.50%
Colorado,2018,G,PUEBLO,3034651052,718,99,817,447,54.71%
Colorado,2018,G,PUEBLO,3034651053,571,62,633,365,57.66%
Colorado,2018,G,PUEBLO,3034651054,462,72,534,278,52.06%
Colorado,2018,G,PUEBLO,3034651055,574,39,613,438,71.45%
Colorado,2018,G,PUEBLO,3034651056,542,33,575,420,73.04%
Colorado,2018,G,PUEBLO,3034651057,789,52,841,571,67.90%
Colorado,2018,G,PUEBLO,3034651058,694,25,719,563,78.30%
Colorado,2018,G,PUEBLO,3034651059,465,57,522,262,50.19%
Colorado,2018,G,PUEBLO,3034651060,904,73,977,660,67.55%
Colorado,2018,G,PUEBLO,3034651061,715,57,772,527,68.26%
Colorado,2018,G,PUEBLO,3034651062,748,64,812,548,67.49%
Colorado,2018,G,PUEBLO,3034651063,1110,83,1193,790,66.22%
Colorado,2018,G,PUEBLO,3034651064,215,37,252,104,41.27%
Colorado,2018,G,PUEBLO,3034651065,114,3,117,92,78.63%
Colorado,2018,G,PUEBLO,3034651066,956,68,1024,738,72.07%
Colorado,2018,G,PUEBLO,3034651067,602,107,709,393,55.43%
Colorado,2018,G,PUEBLO,3034651068,508,58,566,367,64.84%
Colorado,2018,G,PUEBLO,3034651069,813,85,898,519,57.80%
Colorado,2018,G,PUEBLO,3034651070,528,145,673,320,47.55%
Colorado,2018,G,PUEBLO,3034651071,704,109,813,411,50.55%
Colorado,2018,G,PUEBLO,3034651072,748,88,836,441,52.75%
Colorado,2018,G,PUEBLO,3034651073,639,117,756,354,46.83%
Colorado,2018,G,PUEBLO,3034651074,679,141,820,362,44.15%
Colorado,2018,G,PUEBLO,3034651075,829,166,995,478,48.04%
Colorado,2018,G,PUEBLO,3034651076,442,58,500,254,50.80%
Colorado,2018,G,PUEBLO,3034651077,484,142,626,241,38.50%
Colorado,2018,G,PUEBLO,3034651078,552,96,648,299,46.14%
Colorado,2018,G,PUEBLO,3034651079,656,137,793,345,43.51%
Colorado,2018,G,PUEBLO,3034651080,863,109,972,609,62.65%
Colorado,2018,G,PUEBLO,3034651081,756,90,846,488,57.68%
Colorado,2018,G,PUEBLO,3034651082,1342,114,1456,891,61.20%
Colorado,2018,G,PUEBLO,3034651083,754,60,814,489,60.07%
Colorado,2018,G,PUEBLO,3034651084,850,72,922,582,63.12%
Colorado,2018,G,PUEBLO,3034651085,681,84,765,475,62.09%
Colorado,2018,G,PUEBLO,3034651086,978,138,1116,706,63.26%
Colorado,2018,G,PUEBLO,3034651087,853,45,898,689,76.73%
Colorado,2018,G,PUEBLO,3034651088,1455,86,1541,1190,77.22%
Colorado,2018,G,PUEBLO,3034651209,1003,81,1084,809,74.63%
Colorado,2018,G,PUEBLO,3034651210,500,75,575,346,60.17%
Colorado,2018,G,PUEBLO,3034651211,965,155,1120,648,57.86%
Colorado,2018,G,PUEBLO,3034651212,779,191,970,503,51.86%
Colorado,2018,G,PUEBLO,3034651213,1314,109,1423,1061,74.56%
Colorado,2018,G,PUEBLO,3034651214,1504,238,1742,1065,61.14%
Colorado,2018,G,PUEBLO,3034651215,1168,99,1267,902,71.19%
Colorado,2018,G,PUEBLO,3034651216,868,89,957,627,65.52%
Colorado,2018,G,PUEBLO,3034651217,669,61,730,481,65.89%
Colorado,2018,G,PUEBLO,3034651218,1235,113,1348,967,71.74%
Colorado,2018,G,PUEBLO,3034651219,1131,90,1221,859,70.35%
Colorado,2018,G,PUEBLO,3034651220,1018,118,1136,779,68.57%
Colorado,2018,G,PUEBLO,3034751001,1337,277,1614,909,56.32%
Colorado,2018,G,PUEBLO,3034751002,1591,214,1805,1071,59.34%
Colorado,2018,G,PUEBLO,3034751003,1345,172,1517,989,65.19%
Colorado,2018,G,PUEBLO,3034751004,1195,87,1282,968,75.51%
Colorado,2018,G,PUEBLO,3034751005,584,60,644,453,70.34%
Colorado,2018,G,PUEBLO,3034751006,511,241,752,375,49.87%
Colorado,2018,G,PUEBLO,3034751007,1025,101,1126,737,65.45%
Colorado,2018,G,PUEBLO,3034751008,1124,74,1198,831,69.37%
Colorado,2018,G,PUEBLO,3034751009,699,65,764,453,59.29%
Colorado,2018,G,PUEBLO,3034751010,1168,413,1581,691,43.71%
Colorado,2018,G,PUEBLO,3034751011,930,105,1035,667,64.44%
Colorado,2018,G,PUEBLO,3034751015,917,147,1064,591,55.55%
Colorado,2018,G,PUEBLO,3034751016,911,178,1089,589,54.09%
Colorado,2018,G,PUEBLO,3034751017,999,114,1113,717,64.42%
Colorado,2018,G,PUEBLO,3034751018,1461,250,1711,895,52.31%
Colorado,2018,G,PUEBLO,3034751019,326,47,373,183,49.06%
Colorado,2018,G,PUEBLO,3034751022,535,101,636,284,44.65%
Colorado,2018,G,PUEBLO,3034751023,938,173,1111,592,53.29%
Colorado,2018,G,PUEBLO,3034751024,833,151,984,617,62.70%
Colorado,2018,G,PUEBLO,3034751033,216,87,303,120,39.60%
Colorado,2018,G,PUEBLO,3034751034,671,208,879,354,40.27%
Colorado,2018,G,PUEBLO,3034751035,230,50,280,119,42.50%
Colorado,2018,G,PUEBLO,3034751113,667,112,779,399,51.22%
Colorado,2018,G,PUEBLO,3034751201,1327,161,1488,965,64.85%
Colorado,2018,G,PUEBLO,3034751202,1079,134,1213,802,66.12%
Colorado,2018,G,PUEBLO,3034751203,1226,190,1416,859,60.66%
Colorado,2018,G,PUEBLO,3034751204,790,98,888,551,62.05%
Colorado,2018,G,PUEBLO,3034751205,730,113,843,499,59.19%
Colorado,2018,G,PUEBLO,3034751206,971,175,1146,641,55.93%
Colorado,2018,G,PUEBLO,3034751207,1001,133,1134,713,62.87%
Colorado,2018,G,PUEBLO,3034751208,1196,141,1337,775,57.97%
Colorado,2018,G,PUEBLO,3036251012,1090,138,1228,710,57.82%
Colorado,2018,G,PUEBLO,3036251013,984,213,1197,521,43.53%
Colorado,2018,G,PUEBLO,3036251014,810,153,963,406,42.16%
Colorado,2018,G,PUEBLO,3036251025,754,211,965,361,37.41%
Colorado,2018,G,PUEBLO,3036251026,782,105,887,458,51.63%
Colorado,2018,G,PUEBLO,3036251027,761,164,925,425,45.95%
Colorado,2018,G,PUEBLO,3036251028,688,221,909,291,32.01%
Colorado,2018,G,PUEBLO,3036251029,523,116,639,272,42.57%
Colorado,2018,G,PUEBLO,3036251030,863,147,1010,481,47.62%
Colorado,2018,G,PUEBLO,3036251031,912,193,1105,477,43.17%
Colorado,2018,G,PUEBLO,3036251032,586,156,742,284,38.27%
Colorado,2018,G,PUEBLO,3036251045,172,37,209,96,45.93%
Colorado,2018,G,PUEBLO,3036251046,732,114,846,372,43.97%
Colorado,2018,G,PUEBLO,3036251047,560,94,654,279,42.66%
Colorado,2018,G,PUEBLO,3036251101,371,34,405,234,57.78%
Colorado,2018,G,PUEBLO,3036251102,657,38,695,449,64.60%
Colorado,2018,G,PUEBLO,3036251104,892,54,946,650,68.71%
Colorado,2018,G,PUEBLO,3354651301,1528,161,1689,1135,67.20%
Colorado,2018,G,PUEBLO,3354651302,923,77,1000,710,71.00%
Colorado,2018,G,PUEBLO,3354651303,440,29,469,339,72.28%
Colorado,2018,G,PUEBLO,3354651401,790,63,853,633,74.21%
Colorado,2018,G,PUEBLO,3354651402,856,87,943,646,68.50%
Colorado,2018,G,PUEBLO,3354651403,735,73,808,601,74.38%
Colorado,2018,G,PUEBLO,3354751106,987,53,1040,756,72.69%
Colorado,2018,G,PUEBLO,3354751107,1393,91,1484,1045,70.42%
Colorado,2018,G,PUEBLO,3354751108,685,46,731,490,67.03%
Colorado,2018,G,PUEBLO,3354751109,662,77,739,438,59.27%
Colorado,2018,G,PUEBLO,3354751110,228,17,245,159,64.90%
Colorado,2018,G,PUEBLO,3354751111,538,79,617,346,56.08%
Colorado,2018,G,PUEBLO,3354751112,398,61,459,260,56.64%
Colorado,2018,G,PUEBLO,3356251103,754,58,812,544,67.00%
Colorado,2018,G,PUEBLO,3356251105,1238,64,1302,944,72.50%
Colorado,2018,G,PUEBLO,3356251304,448,44,492,366,74.39%
Colorado,2018,G,RIO BLANCO,3085752001,826,159,985,642,65.18%
Colorado,2018,G,RIO BLANCO,3085752002,697,134,831,562,67.63%
Colorado,2018,G,RIO BLANCO,3085752003,1069,220,1289,835,64.78%
Colorado,2018,G,RIO BLANCO,3085752004,1280,140,1420,1055,74.30%
Colorado,2018,G,RIO BLANCO,3085752005,63,9,72,49,68.06%
Colorado,2018,G,RIO GRANDE,3356253001,310,64,374,213,56.95%
Colorado,2018,G,RIO GRANDE,3356253002,542,92,634,395,62.30%
Colorado,2018,G,RIO GRANDE,3356253003,702,130,832,526,63.22%
Colorado,2018,G,RIO GRANDE,3356253004,340,75,415,213,51.33%
Colorado,2018,G,RIO GRANDE,3356253005,424,58,482,343,71.16%
Colorado,2018,G,RIO GRANDE,3356253006,157,21,178,114,64.04%
Colorado,2018,G,RIO GRANDE,3356253007,460,68,528,380,71.97%
Colorado,2018,G,RIO GRANDE,3356253008,638,86,724,459,63.40%
Colorado,2018,G,RIO GRANDE,3356253009,435,62,497,262,52.72%
Colorado,2018,G,RIO GRANDE,3356253010,913,206,1119,719,64.25%
Colorado,2018,G,RIO GRANDE,3356253011,504,74,578,388,67.13%
Colorado,2018,G,RIO GRANDE,3356253012,376,71,447,230,51.45%
Colorado,2018,G,RIO GRANDE,3356253013,341,50,391,252,64.45%
Colorado,2018,G,RIO GRANDE,3356253014,456,93,549,330,60.11%
Colorado,2018,G,RIO GRANDE,3356253015,384,72,456,214,46.93%
Colorado,2018,G,ROUTT,3082654001,831,122,953,675,70.83%
Colorado,2018,G,ROUTT,3082654002,622,78,700,457,65.29%
Colorado,2018,G,ROUTT,3082654003,1042,116,1158,863,74.53%
Colorado,2018,G,ROUTT,3082654004,598,75,673,488,72.51%
Colorado,2018,G,ROUTT,3082654005,1211,207,1418,865,61.00%
Colorado,2018,G,ROUTT,3082654006,1150,148,1298,927,71.42%
Colorado,2018,G,ROUTT,3082654007,523,81,604,404,66.89%
Colorado,2018,G,ROUTT,3082654008,879,185,1064,658,61.84%
Colorado,2018,G,ROUTT,3082654009,798,160,958,640,66.81%
Colorado,2018,G,ROUTT,3082654010,487,85,572,380,66.43%
Colorado,2018,G,ROUTT,3082654011,1219,321,1540,892,57.92%
Colorado,2018,G,ROUTT,3082654012,730,129,859,599,69.73%
Colorado,2018,G,ROUTT,3082654013,1156,225,1381,961,69.59%
Colorado,2018,G,ROUTT,3082654014,886,157,1043,736,70.57%
Colorado,2018,G,ROUTT,3082654015,1437,205,1642,1143,69.61%
Colorado,2018,G,ROUTT,3082654016,1357,257,1614,1063,65.86%
Colorado,2018,G,ROUTT,3082654017,1162,360,1522,854,56.11%
Colorado,2018,G,ROUTT,3082654018,1349,361,1710,1012,59.18%
Colorado,2018,G,SAGUACHE,3356255001,1047,189,1236,807,65.29%
Colorado,2018,G,SAGUACHE,3356255002,101,20,121,76,62.81%
Colorado,2018,G,SAGUACHE,3356255003,248,67,315,180,57.14%
Colorado,2018,G,SAGUACHE,3356255004,240,53,293,180,61.43%
Colorado,2018,G,SAGUACHE,3356255005,917,141,1058,701,66.26%
Colorado,2018,G,SAGUACHE,3356255006,623,98,721,389,53.95%
Colorado,2018,G,SAGUACHE,3356255007,625,104,729,391,53.64%
Colorado,2018,G,SAN JUAN,3065956001,590,157,747,472,63.19%
Colorado,2018,G,SAN MIGUEL,3065857001,1878,425,2303,1421,61.70%
Colorado,2018,G,SAN MIGUEL,3065857002,1222,208,1430,970,67.83%
Colorado,2018,G,SAN MIGUEL,3065857003,616,90,706,496,70.25%
Colorado,2018,G,SAN MIGUEL,3065857004,928,175,1103,707,64.10%
Colorado,2018,G,SAN MIGUEL,3065857005,105,13,118,64,54.24%
Colorado,2018,G,SAN MIGUEL,3065857006,678,236,914,492,53.83%
Colorado,2018,G,SEDGWICK,4016558001,382,61,443,303,68.40%
Colorado,2018,G,SEDGWICK,4016558002,301,60,361,249,68.98%
Colorado,2018,G,SEDGWICK,4016558003,338,39,377,269,71.35%
Colorado,2018,G,SEDGWICK,4016558004,253,41,294,209,71.09%
Colorado,2018,G,SEDGWICK,4016558005,288,80,368,217,58.97%
Colorado,2018,G,SUMMIT,2086159001,1277,677,1954,841,43.04%
Colorado,2018,G,SUMMIT,2086159002,1412,577,1989,968,48.67%
Colorado,2018,G,SUMMIT,2086159003,780,287,1067,577,54.08%
Colorado,2018,G,SUMMIT,2086159004,1499,485,1984,1119,56.40%
Colorado,2018,G,SUMMIT,2086159005,1446,443,1889,1091,57.76%
Colorado,2018,G,SUMMIT,2086159006,756,222,978,572,58.49%
Colorado,2018,G,SUMMIT,2086159007,926,465,1391,606,43.57%
Colorado,2018,G,SUMMIT,2086159008,545,265,810,385,47.53%
Colorado,2018,G,SUMMIT,2086159009,1346,552,1898,928,48.89%
Colorado,2018,G,SUMMIT,2086159010,896,167,1063,708,66.60%
Colorado,2018,G,SUMMIT,2086159011,691,174,865,552,63.82%
Colorado,2018,G,SUMMIT,2086159012,340,63,403,257,63.77%
Colorado,2018,G,SUMMIT,2086159013,1059,238,1297,858,66.15%
Colorado,2018,G,SUMMIT,2086159014,719,347,1066,497,46.62%
Colorado,2018,G,SUMMIT,2086159015,887,305,1192,665,55.79%
Colorado,2018,G,SUMMIT,2086159016,870,353,1223,654,53.48%
Colorado,2018,G,SUMMIT,2086159017,1165,446,1611,875,54.31%
Colorado,2018,G,SUMMIT,2086159018,1118,636,1754,778,44.36%
Colorado,2018,G,SUMMIT,2086159019,1139,389,1528,849,55.56%
Colorado,2018,G,SUMMIT,2086159020,1044,392,1436,703,48.96%
Colorado,2018,G,TELLER,5023960001,1508,323,1831,1148,62.70%
Colorado,2018,G,TELLER,5023960002,1368,282,1650,1058,64.12%
Colorado,2018,G,TELLER,5023960003,1570,360,1930,1180,61.14%
Colorado,2018,G,TELLER,5023960004,1575,247,1822,1162,63.78%
Colorado,2018,G,TELLER,5023960005,859,127,986,704,71.40%
Colorado,2018,G,TELLER,5023960006,398,98,496,301,60.69%
Colorado,2018,G,TELLER,5023960007,1762,287,2049,1302,63.54%
Colorado,2018,G,TELLER,5023960008,1469,240,1709,1169,68.40%
Colorado,2018,G,TELLER,5023960009,1556,227,1783,1232,69.10%
Colorado,2018,G,TELLER,5023960010,1264,244,1508,910,60.34%
Colorado,2018,G,TELLER,5023960011,1827,398,2225,1313,59.01%
Colorado,2018,G,TELLER,5023960012,1254,204,1458,925,63.44%
Colorado,2018,G,TELLER,5023960013,900,237,1137,637,56.02%
Colorado,2018,G,WASHINGTON,4016461001,123,10,133,101,75.94%
Colorado,2018,G,WASHINGTON,4016461002,1546,215,1761,1246,70.76%
Colorado,2018,G,WASHINGTON,4016461003,165,11,176,133,75.57%
Colorado,2018,G,WASHINGTON,4016461004,593,63,656,463,70.58%
Colorado,2018,G,WASHINGTON,4016461005,241,23,264,189,71.59%
Colorado,2018,G,WASHINGTON,4016461006,390,28,418,328,78.47%
Colorado,2018,G,WELD,4014862118,1316,99,1415,1054,74.49%
Colorado,2018,G,WELD,4014862119,737,85,822,539,65.57%
Colorado,2018,G,WELD,4014862126,1525,173,1698,1166,68.67%
Colorado,2018,G,WELD,4014862127,1160,148,1308,860,65.75%
Colorado,2018,G,WELD,4014862128,933,73,1006,791,78.63%
Colorado,2018,G,WELD,4014862134,1516,121,1637,1247,76.18%
Colorado,2018,G,WELD,4014862152,839,58,897,699,77.93%
Colorado,2018,G,WELD,4014862316,928,56,984,737,74.90%
Colorado,2018,G,WELD,4016362100,1377,169,1546,1062,68.69%
Colorado,2018,G,WELD,4016362101,395,43,438,314,71.69%
Colorado,2018,G,WELD,4016362102,283,30,313,247,78.91%
Colorado,2018,G,WELD,4016362103,497,42,539,417,77.37%
Colorado,2018,G,WELD,4016362104,1072,103,1175,844,71.83%
Colorado,2018,G,WELD,4016362144,854,69,923,689,74.65%
Colorado,2018,G,WELD,4016362308,864,58,922,725,78.63%
Colorado,2018,G,WELD,4016362310,990,144,1134,673,59.35%
Colorado,2018,G,WELD,4016362311,1011,166,1177,759,64.49%
Colorado,2018,G,WELD,4016362312,498,49,547,413,75.50%
Colorado,2018,G,WELD,4016362314,1512,163,1675,983,58.69%
Colorado,2018,G,WELD,4016362320,1138,136,1274,842,66.09%
Colorado,2018,G,WELD,4016362327,1809,273,2082,1172,56.29%
Colorado,2018,G,WELD,4016362342,961,65,1026,755,73.59%
Colorado,2018,G,WELD,4016362345,1030,138,1168,815,69.78%
Colorado,2018,G,WELD,4134862120,554,44,598,468,78.26%
Colorado,2018,G,WELD,4134862124,1023,108,1131,817,72.24%
Colorado,2018,G,WELD,4134862125,974,62,1036,868,83.78%
Colorado,2018,G,WELD,4134862135,1093,87,1180,885,75.00%
Colorado,2018,G,WELD,4134862136,1257,130,1387,995,71.74%
Colorado,2018,G,WELD,4134862146,556,82,638,301,47.18%
Colorado,2018,G,WELD,4134862150,825,88,913,660,72.29%
Colorado,2018,G,WELD,4134862151,940,124,1064,749,70.39%
Colorado,2018,G,WELD,4134862212,1365,200,1565,1105,70.61%
Colorado,2018,G,WELD,4134862213,1559,198,1757,1157,65.85%
Colorado,2018,G,WELD,4134862214,1360,70,1430,1184,82.80%
Colorado,2018,G,WELD,4134862215,1232,85,1317,1033,78.44%
Colorado,2018,G,WELD,4134862217,1642,244,1886,1190,63.10%
Colorado,2018,G,WELD,4134862221,1100,118,1218,871,71.51%
Colorado,2018,G,WELD,4134862222,1426,132,1558,1194,76.64%
Colorado,2018,G,WELD,4134862223,1242,135,1377,1038,75.38%
Colorado,2018,G,WELD,4134862224,781,80,861,604,70.15%
Colorado,2018,G,WELD,4134862225,1305,162,1467,995,67.83%
Colorado,2018,G,WELD,4134862226,563,128,691,416,60.20%
Colorado,2018,G,WELD,4134862228,1613,235,1848,1093,59.15%
Colorado,2018,G,WELD,4134862235,962,62,1024,810,79.10%
Colorado,2018,G,WELD,4134862238,1302,252,1554,940,60.49%
Colorado,2018,G,WELD,4134862241,826,100,926,617,66.63%
Colorado,2018,G,WELD,4134862243,1266,129,1395,996,71.40%
Colorado,2018,G,WELD,4134862246,1973,225,2198,1440,65.51%
Colorado,2018,G,WELD,4134862248,673,314,987,407,41.24%
Colorado,2018,G,WELD,4134862250,1203,204,1407,857,60.91%
Colorado,2018,G,WELD,4134862253,898,70,968,703,72.62%
Colorado,2018,G,WELD,4134862255,1221,143,1364,963,70.60%
Colorado,2018,G,WELD,4134862309,874,83,957,653,68.23%
Colorado,2018,G,WELD,4134862326,1167,129,1296,822,63.43%
Colorado,2018,G,WELD,4134862331,1458,127,1585,1136,71.67%
Colorado,2018,G,WELD,4134862333,758,107,865,523,60.46%
Colorado,2018,G,WELD,4134862338,113,6,119,85,71.43%
Colorado,2018,G,WELD,4134862341,1102,148,1250,768,61.44%
Colorado,2018,G,WELD,4134962145,18,2,20,12,60.00%
Colorado,2018,G,WELD,4135062105,1449,299,1748,785,44.91%
Colorado,2018,G,WELD,4135062106,1506,226,1732,821,47.40%
Colorado,2018,G,WELD,4135062107,1400,390,1790,755,42.18%
Colorado,2018,G,WELD,4135062108,1461,330,1791,925,51.65%
Colorado,2018,G,WELD,4135062109,1081,166,1247,733,58.78%
Colorado,2018,G,WELD,4135062110,874,352,1226,527,42.99%
Colorado,2018,G,WELD,4135062111,1481,293,1774,976,55.02%
Colorado,2018,G,WELD,4135062112,1159,453,1612,780,48.39%
Colorado,2018,G,WELD,4135062113,1127,493,1620,719,44.38%
Colorado,2018,G,WELD,4135062114,1064,134,1198,863,72.04%
Colorado,2018,G,WELD,4135062132,1071,106,1177,850,72.22%
Colorado,2018,G,WELD,4135062137,1097,357,1454,607,41.75%
Colorado,2018,G,WELD,4135062141,1249,254,1503,704,46.84%
Colorado,2018,G,WELD,4135062142,509,218,727,289,39.75%
Colorado,2018,G,WELD,4135062147,635,190,825,344,41.70%
Colorado,2018,G,WELD,4135062211,1374,210,1584,922,58.21%
Colorado,2018,G,WELD,4135062220,848,67,915,660,72.13%
Colorado,2018,G,WELD,4135062236,1708,159,1867,1204,64.49%
Colorado,2018,G,WELD,4135062247,907,259,1166,590,50.60%
Colorado,2018,G,WELD,4135062249,1240,181,1421,922,64.88%
Colorado,2018,G,WELD,4135062317,1379,568,1947,992,50.95%
Colorado,2018,G,WELD,4135062318,942,164,1106,678,61.30%
Colorado,2018,G,WELD,4135062319,1209,349,1558,750,48.14%
Colorado,2018,G,WELD,4135062321,1353,448,1801,674,37.42%
Colorado,2018,G,WELD,4135062322,1497,289,1786,939,52.58%
Colorado,2018,G,WELD,4135062323,1522,220,1742,994,57.06%
Colorado,2018,G,WELD,4135062324,1477,256,1733,991,57.18%
Colorado,2018,G,WELD,4135062325,1242,357,1599,790,49.41%
Colorado,2018,G,WELD,4135062329,1330,278,1608,910,56.59%
Colorado,2018,G,WELD,4135062330,1070,191,1261,697,55.27%
Colorado,2018,G,WELD,4135062343,894,115,1009,651,64.52%
Colorado,2018,G,WELD,4136362202,444,31,475,333,70.11%
Colorado,2018,G,WELD,4136362300,1392,153,1545,938,60.71%
Colorado,2018,G,WELD,4136362301,1466,148,1614,960,59.48%
Colorado,2018,G,WELD,4136362302,1514,199,1713,1009,58.90%
Colorado,2018,G,WELD,4136362303,850,111,961,654,68.05%
Colorado,2018,G,WELD,4136362304,1396,146,1542,1029,66.73%
Colorado,2018,G,WELD,4136362313,660,48,708,493,69.63%
Colorado,2018,G,WELD,4234862117,1130,91,1221,946,77.48%
Colorado,2018,G,WELD,4234862131,945,87,1032,800,77.52%
Colorado,2018,G,WELD,4234862138,1674,157,1831,1302,71.11%
Colorado,2018,G,WELD,4234862153,805,62,867,660,76.12%
Colorado,2018,G,WELD,4234862227,1298,135,1433,954,66.57%
Colorado,2018,G,WELD,4234862230,840,97,937,651,69.48%
Colorado,2018,G,WELD,4234862232,952,120,1072,685,63.90%
Colorado,2018,G,WELD,4234862244,1545,202,1747,1143,65.43%
Colorado,2018,G,WELD,4234862245,1644,189,1833,1306,71.25%
Colorado,2018,G,WELD,4234862251,862,78,940,678,72.13%
Colorado,2018,G,WELD,4234862252,929,113,1042,655,62.86%
Colorado,2018,G,WELD,4234962115,1093,155,1248,867,69.47%
Colorado,2018,G,WELD,4234962116,1043,153,1196,803,67.14%
Colorado,2018,G,WELD,4234962121,761,50,811,642,79.16%
Colorado,2018,G,WELD,4234962122,873,132,1005,627,62.39%
Colorado,2018,G,WELD,4234962123,1388,193,1581,1032,65.28%
Colorado,2018,G,WELD,4234962129,141,11,152,116,76.32%
Colorado,2018,G,WELD,4234962130,1682,113,1795,1440,80.22%
Colorado,2018,G,WELD,4234962133,1588,119,1707,1290,75.57%
Colorado,2018,G,WELD,4234962139,1506,132,1638,1242,75.82%
Colorado,2018,G,WELD,4234962140,1474,161,1635,1205,73.70%
Colorado,2018,G,WELD,4234962143,1342,56,1398,1091,78.04%
Colorado,2018,G,WELD,4234962148,779,73,852,607,71.24%
Colorado,2018,G,WELD,4234962149,679,100,779,525,67.39%
Colorado,2018,G,WELD,4234962229,1132,70,1202,932,77.54%
Colorado,2018,G,WELD,4234962231,363,21,384,304,79.17%
Colorado,2018,G,WELD,4236362200,1463,111,1574,1158,73.57%
Colorado,2018,G,WELD,4236362203,964,118,1082,699,64.60%
Colorado,2018,G,WELD,4236362204,964,106,1070,717,67.01%
Colorado,2018,G,WELD,4236362205,1077,118,1195,783,65.52%
Colorado,2018,G,WELD,4236362206,1022,116,1138,772,67.84%
Colorado,2018,G,WELD,4236362207,1666,164,1830,1246,68.09%
Colorado,2018,G,WELD,4236362208,948,74,1022,796,77.89%
Colorado,2018,G,WELD,4236362209,1444,199,1643,1005,61.17%
Colorado,2018,G,WELD,4236362210,1078,124,1202,848,70.55%
Colorado,2018,G,WELD,4236362216,883,84,967,702,72.60%
Colorado,2018,G,WELD,4236362218,1344,143,1487,1034,69.54%
Colorado,2018,G,WELD,4236362219,1000,92,1092,779,71.34%
Colorado,2018,G,WELD,4236362233,1397,197,1594,958,60.10%
Colorado,2018,G,WELD,4236362234,1114,171,1285,717,55.80%
Colorado,2018,G,WELD,4236362237,1304,97,1401,1061,75.73%
Colorado,2018,G,WELD,4236362239,939,138,1077,678,62.95%
Colorado,2018,G,WELD,4236362240,1579,169,1748,1251,71.57%
Colorado,2018,G,WELD,4236362242,1502,176,1678,1118,66.63%
Colorado,2018,G,WELD,4236362254,813,78,891,621,69.70%
Colorado,2018,G,WELD,4236362305,1057,67,1124,817,72.69%
Colorado,2018,G,WELD,4236362306,1229,142,1371,916,66.81%
Colorado,2018,G,WELD,4236362307,2088,143,2231,1688,75.66%
Colorado,2018,G,WELD,4236362315,3,2,5,0,0.00%
Colorado,2018,G,WELD,4236362328,298,17,315,234,74.29%
Colorado,2018,G,WELD,4236362332,957,130,1087,789,72.59%
Colorado,2018,G,WELD,4236362334,1646,265,1911,1298,67.92%
Colorado,2018,G,WELD,4236362335,1283,102,1385,1098,79.28%
Colorado,2018,G,WELD,4236362336,771,91,862,629,72.97%
Colorado,2018,G,WELD,4236362337,1196,183,1379,838,60.77%
Colorado,2018,G,WELD,4236362339,1368,107,1475,1101,74.64%
Colorado,2018,G,WELD,4236362340,1600,230,1830,1076,58.80%
Colorado,2018,G,WELD,4236362344,1026,91,1117,837,74.93%
Colorado,2018,G,WELD,4236362346,1250,130,1380,1028,74.49%
Colorado,2018,G,YUMA,4016563001,430,38,468,338,72.22%
Colorado,2018,G,YUMA,4016563002,437,67,504,323,64.09%
Colorado,2018,G,YUMA,4016563003,218,43,261,155,59.39%
Colorado,2018,G,YUMA,4016563004,739,87,826,571,69.13%
Colorado,2018,G,YUMA,4016563005,170,12,182,123,67.58%
Colorado,2018,G,YUMA,4016563006,554,66,620,458,73.87%
Colorado,2018,G,YUMA,4016563007,135,10,145,113,77.93%
Colorado,2018,G,YUMA,4016563008,187,14,201,156,77.61%
Colorado,2018,G,YUMA,4016563009,322,25,347,262,75.50%
Colorado,2018,G,YUMA,4016563010,319,14,333,247,74.17%
Colorado,2018,G,YUMA,4016563011,454,50,504,332,65.87%
Colorado,2018,G,YUMA,4016563012,516,59,575,418,72.70%
Colorado,2018,G,YUMA,4016563013,505,74,579,365,63.04%
Colorado,2018,G,YUMA,4016563014,496,55,551,348,63.16%
