State,Year,Election Type,County,Precinct,Active Voters,Inactive Voters,Total Voters,Ballots Cast,Total Voters Turnout %
Colorado,2020,General,ADAMS,4253001245,419,34,453,360,79.47%
Colorado,2020,General,ADAMS,4255601241,53,6,59,40,67.80%
Colorado,2020,General,ADAMS,4255601246,1460,135,1595,1230,77.12%
Colorado,2020,General,ADAMS,4255601247,1030,74,1104,921,83.42%
Colorado,2020,General,ADAMS,4255601248,1092,94,1186,969,81.70%
Colorado,2020,General,ADAMS,4255601249,386,46,432,342,79.17%
Colorado,2020,General,ADAMS,4255601251,1323,127,1450,1166,80.41%
Colorado,2020,General,ADAMS,6243101150,1653,107,1760,1463,83.13%
Colorado,2020,General,ADAMS,6243101151,1488,93,1581,1308,82.73%
Colorado,2020,General,ADAMS,6243101159,872,27,899,803,89.32%
Colorado,2020,General,ADAMS,6243101256,1311,65,1376,1195,86.85%
Colorado,2020,General,ADAMS,6243401075,725,134,859,603,70.20%
Colorado,2020,General,ADAMS,6243401076,1329,85,1414,1204,85.15%
Colorado,2020,General,ADAMS,6243401077,942,58,1000,830,83.00%
Colorado,2020,General,ADAMS,6243401252,1638,110,1748,1494,85.47%
Colorado,2020,General,ADAMS,6245601071,939,67,1006,842,83.70%
Colorado,2020,General,ADAMS,6245601072,821,21,842,735,87.29%
Colorado,2020,General,ADAMS,6245601073,1214,60,1274,1135,89.09%
Colorado,2020,General,ADAMS,6245601074,1186,52,1238,1054,85.14%
Colorado,2020,General,ADAMS,6245601160,615,12,627,562,89.63%
Colorado,2020,General,ADAMS,6245601259,747,9,756,692,91.53%
Colorado,2020,General,ADAMS,6253001152,1291,95,1386,1147,82.76%
Colorado,2020,General,ADAMS,6253001153,956,48,1004,839,83.57%
Colorado,2020,General,ADAMS,6253001154,69,3,72,54,75.00%
Colorado,2020,General,ADAMS,6253001155,398,27,425,357,84.00%
Colorado,2020,General,ADAMS,6253001156,944,34,978,850,86.91%
Colorado,2020,General,ADAMS,6253001157,968,57,1025,897,87.51%
Colorado,2020,General,ADAMS,6253001226,239,9,248,195,78.63%
Colorado,2020,General,ADAMS,6253001229,1603,370,1973,1011,51.24%
Colorado,2020,General,ADAMS,6253001230,1784,259,2043,1362,66.67%
Colorado,2020,General,ADAMS,6253001231,1983,249,2232,1514,67.83%
Colorado,2020,General,ADAMS,6253001232,2154,477,2631,1564,59.45%
Colorado,2020,General,ADAMS,6253001233,1606,168,1774,1232,69.45%
Colorado,2020,General,ADAMS,6253001234,1289,172,1461,949,64.96%
Colorado,2020,General,ADAMS,6253001235,865,162,1027,555,54.04%
Colorado,2020,General,ADAMS,6253001236,1444,136,1580,1085,68.67%
Colorado,2020,General,ADAMS,6253001237,1199,178,1377,814,59.11%
Colorado,2020,General,ADAMS,6253001238,1358,123,1481,1056,71.30%
Colorado,2020,General,ADAMS,6253001239,1219,109,1328,965,72.67%
Colorado,2020,General,ADAMS,6253001240,1201,63,1264,1017,80.46%
Colorado,2020,General,ADAMS,6253001242,527,41,568,456,80.28%
Colorado,2020,General,ADAMS,6253001243,1042,58,1100,928,84.36%
Colorado,2020,General,ADAMS,6253001253,676,142,818,467,57.09%
Colorado,2020,General,ADAMS,6253001258,1088,129,1217,872,71.65%
Colorado,2020,General,ADAMS,6253101158,1107,73,1180,960,81.36%
Colorado,2020,General,ADAMS,6255601161,382,15,397,345,86.90%
Colorado,2020,General,ADAMS,6255601162,1020,27,1047,950,90.74%
Colorado,2020,General,ADAMS,6255601163,678,34,712,601,84.41%
Colorado,2020,General,ADAMS,6255601164,558,25,583,500,85.76%
Colorado,2020,General,ADAMS,6255601165,1696,69,1765,1638,92.80%
Colorado,2020,General,ADAMS,6255601166,507,37,544,479,88.05%
Colorado,2020,General,ADAMS,6255601167,633,32,665,583,87.67%
Colorado,2020,General,ADAMS,6255601168,788,34,822,713,86.74%
Colorado,2020,General,ADAMS,6255601169,533,29,562,476,84.70%
Colorado,2020,General,ADAMS,6255601170,1524,148,1672,1113,66.57%
Colorado,2020,General,ADAMS,6255601171,1507,107,1614,1213,75.15%
Colorado,2020,General,ADAMS,6255601172,316,42,358,254,70.95%
Colorado,2020,General,ADAMS,6255601173,89,4,93,81,87.10%
Colorado,2020,General,ADAMS,6255601174,525,52,577,463,80.24%
Colorado,2020,General,ADAMS,6255601175,1486,133,1619,1303,80.48%
Colorado,2020,General,ADAMS,6255601176,534,74,608,465,76.48%
Colorado,2020,General,ADAMS,6255601177,595,19,614,509,82.90%
Colorado,2020,General,ADAMS,6255601178,46,0,46,43,93.48%
Colorado,2020,General,ADAMS,6255601179,111,0,111,101,90.99%
Colorado,2020,General,ADAMS,6255601180,1052,77,1129,940,83.26%
Colorado,2020,General,ADAMS,6255601181,1386,153,1539,1177,76.48%
Colorado,2020,General,ADAMS,6255601182,903,82,985,767,77.87%
Colorado,2020,General,ADAMS,6255601183,388,40,428,339,79.21%
Colorado,2020,General,ADAMS,6255601184,367,31,398,313,78.64%
Colorado,2020,General,ADAMS,6255601185,665,33,698,585,83.81%
Colorado,2020,General,ADAMS,6255601186,1461,101,1562,1161,74.33%
Colorado,2020,General,ADAMS,6255601187,1184,154,1338,930,69.51%
Colorado,2020,General,ADAMS,6255601188,862,72,934,744,79.66%
Colorado,2020,General,ADAMS,6255601189,828,43,871,738,84.73%
Colorado,2020,General,ADAMS,6255601190,1297,93,1390,1077,77.48%
Colorado,2020,General,ADAMS,6255601191,1652,152,1804,1311,72.67%
Colorado,2020,General,ADAMS,6255601192,1035,124,1159,794,68.51%
Colorado,2020,General,ADAMS,6255601193,1346,138,1484,1056,71.16%
Colorado,2020,General,ADAMS,6255601194,497,86,583,411,70.50%
Colorado,2020,General,ADAMS,6255601195,513,25,538,472,87.73%
Colorado,2020,General,ADAMS,6255601196,238,29,267,180,67.42%
Colorado,2020,General,ADAMS,6255601197,414,58,472,320,67.80%
Colorado,2020,General,ADAMS,6255601198,872,27,899,771,85.76%
Colorado,2020,General,ADAMS,6255601227,378,17,395,337,85.32%
Colorado,2020,General,ADAMS,6255601228,1001,53,1054,902,85.58%
Colorado,2020,General,ADAMS,6255601244,921,40,961,849,88.35%
Colorado,2020,General,ADAMS,7213001130,321,26,347,261,75.22%
Colorado,2020,General,ADAMS,7213001140,776,74,850,653,76.82%
Colorado,2020,General,ADAMS,7213001141,1365,131,1496,1132,75.67%
Colorado,2020,General,ADAMS,7213001199,892,92,984,780,79.27%
Colorado,2020,General,ADAMS,7213001200,130,6,136,116,85.29%
Colorado,2020,General,ADAMS,7213001201,515,32,547,446,81.54%
Colorado,2020,General,ADAMS,7213001202,702,40,742,604,81.40%
Colorado,2020,General,ADAMS,7213001203,703,45,748,649,86.76%
Colorado,2020,General,ADAMS,7213001204,763,71,834,664,79.62%
Colorado,2020,General,ADAMS,7213001205,1451,112,1563,1233,78.89%
Colorado,2020,General,ADAMS,7213001206,1495,78,1573,1278,81.25%
Colorado,2020,General,ADAMS,7213001207,783,78,861,668,77.58%
Colorado,2020,General,ADAMS,7213001210,2001,150,2151,1708,79.40%
Colorado,2020,General,ADAMS,7213001211,474,58,532,387,72.74%
Colorado,2020,General,ADAMS,7213001212,751,37,788,677,85.91%
Colorado,2020,General,ADAMS,7213001213,996,71,1067,874,81.91%
Colorado,2020,General,ADAMS,7213001214,1208,115,1323,1044,78.91%
Colorado,2020,General,ADAMS,7213001215,1316,173,1489,1136,76.29%
Colorado,2020,General,ADAMS,7213001225,231,11,242,206,85.12%
Colorado,2020,General,ADAMS,7213101117,1850,119,1969,1434,72.83%
Colorado,2020,General,ADAMS,7213101118,1127,109,1236,848,68.61%
Colorado,2020,General,ADAMS,7213201001,1661,266,1927,1206,62.58%
Colorado,2020,General,ADAMS,7213201002,1823,133,1956,1491,76.23%
Colorado,2020,General,ADAMS,7213201003,1052,57,1109,891,80.34%
Colorado,2020,General,ADAMS,7213201004,1038,101,1139,797,69.97%
Colorado,2020,General,ADAMS,7213201005,1748,145,1893,1377,72.74%
Colorado,2020,General,ADAMS,7213201006,1322,136,1458,936,64.20%
Colorado,2020,General,ADAMS,7213201007,1407,114,1521,1121,73.70%
Colorado,2020,General,ADAMS,7213201008,1099,77,1176,940,79.93%
Colorado,2020,General,ADAMS,7213201009,994,79,1073,866,80.71%
Colorado,2020,General,ADAMS,7213201021,1668,164,1832,1242,67.79%
Colorado,2020,General,ADAMS,7213201022,1568,95,1663,1201,72.22%
Colorado,2020,General,ADAMS,7213201023,1153,95,1248,912,73.08%
Colorado,2020,General,ADAMS,7213201119,1495,176,1671,1113,66.61%
Colorado,2020,General,ADAMS,7213201120,1449,119,1568,1124,71.68%
Colorado,2020,General,ADAMS,7213201121,1291,99,1390,988,71.08%
Colorado,2020,General,ADAMS,7213201122,835,97,932,631,67.70%
Colorado,2020,General,ADAMS,7213201123,1699,167,1866,1165,62.43%
Colorado,2020,General,ADAMS,7213201124,1641,128,1769,1159,65.52%
Colorado,2020,General,ADAMS,7213201125,1040,104,1144,747,65.30%
Colorado,2020,General,ADAMS,7213201126,1822,149,1971,1299,65.91%
Colorado,2020,General,ADAMS,7213201127,1151,99,1250,824,65.92%
Colorado,2020,General,ADAMS,7213201128,1921,154,2075,1348,64.96%
Colorado,2020,General,ADAMS,7213201129,1637,178,1815,1141,62.87%
Colorado,2020,General,ADAMS,7213201208,673,52,725,528,72.83%
Colorado,2020,General,ADAMS,7213201209,1093,90,1183,878,74.22%
Colorado,2020,General,ADAMS,7213201216,1795,181,1976,1488,75.30%
Colorado,2020,General,ADAMS,7213201217,1047,98,1145,875,76.42%
Colorado,2020,General,ADAMS,7213201218,924,87,1011,803,79.43%
Colorado,2020,General,ADAMS,7213201219,659,44,703,552,78.52%
Colorado,2020,General,ADAMS,7213201220,268,0,268,226,84.33%
Colorado,2020,General,ADAMS,7213201221,536,60,596,473,79.36%
Colorado,2020,General,ADAMS,7213201222,444,4,448,380,84.82%
Colorado,2020,General,ADAMS,7213201224,45,3,48,40,83.33%
Colorado,2020,General,ADAMS,7213201254,980,116,1096,699,63.78%
Colorado,2020,General,ADAMS,7213201255,776,53,829,538,64.90%
Colorado,2020,General,ADAMS,7213201257,1143,58,1201,1084,90.26%
Colorado,2020,General,ADAMS,7213401027,918,183,1101,662,60.13%
Colorado,2020,General,ADAMS,7213401030,1176,100,1276,867,67.95%
Colorado,2020,General,ADAMS,7213401035,1310,144,1454,867,59.63%
Colorado,2020,General,ADAMS,7213401036,904,87,991,806,81.33%
Colorado,2020,General,ADAMS,7213401042,1173,194,1367,942,68.91%
Colorado,2020,General,ADAMS,7213501010,1609,259,1868,1234,66.06%
Colorado,2020,General,ADAMS,7213501011,1907,169,2076,1478,71.19%
Colorado,2020,General,ADAMS,7213501012,1309,98,1407,1070,76.05%
Colorado,2020,General,ADAMS,7213501013,1848,182,2030,1468,72.32%
Colorado,2020,General,ADAMS,7213501014,1297,100,1397,1059,75.81%
Colorado,2020,General,ADAMS,7213501015,1631,257,1888,1216,64.41%
Colorado,2020,General,ADAMS,7213501016,1259,76,1335,1078,80.75%
Colorado,2020,General,ADAMS,7213501017,1132,85,1217,932,76.58%
Colorado,2020,General,ADAMS,7213501018,1197,129,1326,940,70.89%
Colorado,2020,General,ADAMS,7213501019,894,74,968,710,73.35%
Colorado,2020,General,ADAMS,7213501020,1431,161,1592,1053,66.14%
Colorado,2020,General,ADAMS,7213501024,1504,81,1585,1186,74.83%
Colorado,2020,General,ADAMS,7213501025,1504,117,1621,1162,71.68%
Colorado,2020,General,ADAMS,7213501026,1969,211,2180,1588,72.84%
Colorado,2020,General,ADAMS,7243101078,624,44,668,540,80.84%
Colorado,2020,General,ADAMS,7243101079,889,46,935,813,86.95%
Colorado,2020,General,ADAMS,7243101085,1280,60,1340,1135,84.70%
Colorado,2020,General,ADAMS,7243101086,1160,52,1212,1019,84.08%
Colorado,2020,General,ADAMS,7243101088,1411,72,1483,1277,86.11%
Colorado,2020,General,ADAMS,7243101089,1389,198,1587,1169,73.66%
Colorado,2020,General,ADAMS,7243101093,1657,180,1837,1377,74.96%
Colorado,2020,General,ADAMS,7243101094,1404,100,1504,1182,78.59%
Colorado,2020,General,ADAMS,7243101097,1256,80,1336,1068,79.94%
Colorado,2020,General,ADAMS,7243101105,213,65,278,162,58.27%
Colorado,2020,General,ADAMS,7243101134,1610,158,1768,1309,74.04%
Colorado,2020,General,ADAMS,7243101135,1637,127,1764,1354,76.76%
Colorado,2020,General,ADAMS,7243101136,1200,87,1287,1024,79.56%
Colorado,2020,General,ADAMS,7243101137,1662,105,1767,1458,82.51%
Colorado,2020,General,ADAMS,7243101145,1674,125,1799,1436,79.82%
Colorado,2020,General,ADAMS,7243101146,1271,209,1480,1037,70.07%
Colorado,2020,General,ADAMS,7243101147,1890,151,2041,1576,77.22%
Colorado,2020,General,ADAMS,7243101149,1221,71,1292,1079,83.51%
Colorado,2020,General,ADAMS,7243401037,1147,100,1247,752,60.30%
Colorado,2020,General,ADAMS,7243401038,1728,151,1879,1326,70.57%
Colorado,2020,General,ADAMS,7243401039,1144,85,1229,955,77.71%
Colorado,2020,General,ADAMS,7243401040,1190,87,1277,1005,78.70%
Colorado,2020,General,ADAMS,7243401041,1228,142,1370,991,72.34%
Colorado,2020,General,ADAMS,7243401051,1690,128,1818,1440,79.21%
Colorado,2020,General,ADAMS,7243401052,1941,272,2213,1545,69.81%
Colorado,2020,General,ADAMS,7243401053,1273,69,1342,1136,84.65%
Colorado,2020,General,ADAMS,7243401080,1081,73,1154,991,85.88%
Colorado,2020,General,ADAMS,7243401081,1145,74,1219,1003,82.28%
Colorado,2020,General,ADAMS,7243401082,1037,72,1109,963,86.83%
Colorado,2020,General,ADAMS,7243401083,1268,133,1401,1101,78.59%
Colorado,2020,General,ADAMS,7243401084,773,49,822,681,82.85%
Colorado,2020,General,ADAMS,7243401087,1547,373,1920,1223,63.70%
Colorado,2020,General,ADAMS,7243401090,1486,347,1833,1105,60.28%
Colorado,2020,General,ADAMS,7243401091,1425,253,1678,1081,64.42%
Colorado,2020,General,ADAMS,7243401092,1554,98,1652,1280,77.48%
Colorado,2020,General,ADAMS,7243401095,1453,97,1550,1193,76.97%
Colorado,2020,General,ADAMS,7243401096,1227,75,1302,990,76.04%
Colorado,2020,General,ADAMS,7243401098,1224,90,1314,1020,77.63%
Colorado,2020,General,ADAMS,7243401099,893,62,955,731,76.54%
Colorado,2020,General,ADAMS,7243401100,1448,176,1624,1153,71.00%
Colorado,2020,General,ADAMS,7243401101,1399,127,1526,1192,78.11%
Colorado,2020,General,ADAMS,7243401102,1289,86,1375,1077,78.33%
Colorado,2020,General,ADAMS,7243401103,687,154,841,559,66.47%
Colorado,2020,General,ADAMS,7243401104,1230,91,1321,1030,77.97%
Colorado,2020,General,ADAMS,7243501031,1565,115,1680,1331,79.23%
Colorado,2020,General,ADAMS,7243501032,1268,107,1375,1030,74.91%
Colorado,2020,General,ADAMS,7243501033,1748,190,1938,1523,78.59%
Colorado,2020,General,ADAMS,7243501034,1355,94,1449,1130,77.98%
Colorado,2020,General,ADAMS,7243501043,1068,52,1120,992,88.57%
Colorado,2020,General,ADAMS,7243501044,1122,123,1245,963,77.35%
Colorado,2020,General,ADAMS,7243501045,762,41,803,700,87.17%
Colorado,2020,General,ADAMS,7243501046,770,29,799,730,91.36%
Colorado,2020,General,ADAMS,7243501047,1167,67,1234,1090,88.33%
Colorado,2020,General,ADAMS,7243501048,920,51,971,869,89.50%
Colorado,2020,General,ADAMS,7243501049,1224,91,1315,1108,84.26%
Colorado,2020,General,ADAMS,7243501050,1028,115,1143,915,80.05%
Colorado,2020,General,ADAMS,7243501054,951,53,1004,850,84.66%
Colorado,2020,General,ADAMS,7243501055,897,93,990,826,83.43%
Colorado,2020,General,ADAMS,7243501056,1414,98,1512,1317,87.10%
Colorado,2020,General,ADAMS,7243501057,1056,61,1117,952,85.23%
Colorado,2020,General,ADAMS,7243501058,1270,164,1434,1153,80.40%
Colorado,2020,General,ADAMS,7243501059,1154,60,1214,1071,88.22%
Colorado,2020,General,ADAMS,7243501060,1249,153,1402,1097,78.25%
Colorado,2020,General,ADAMS,7243501061,1415,210,1625,1199,73.78%
Colorado,2020,General,ADAMS,7243501062,1279,101,1380,1158,83.91%
Colorado,2020,General,ADAMS,7243501063,1284,99,1383,1161,83.95%
Colorado,2020,General,ADAMS,7243501064,1710,301,2011,1391,69.17%
Colorado,2020,General,ADAMS,7243501065,1162,60,1222,1043,85.35%
Colorado,2020,General,ADAMS,7243501066,517,53,570,393,68.95%
Colorado,2020,General,ADAMS,7243501067,675,68,743,579,77.93%
Colorado,2020,General,ADAMS,7243501068,1396,103,1499,1236,82.45%
Colorado,2020,General,ADAMS,7243501069,1402,217,1619,1257,77.64%
Colorado,2020,General,ADAMS,7243501070,1019,54,1073,934,87.05%
Colorado,2020,General,ADAMS,7253001131,934,93,1027,653,63.58%
Colorado,2020,General,ADAMS,7253001132,1773,123,1896,1409,74.31%
Colorado,2020,General,ADAMS,7253001138,932,66,998,807,80.86%
Colorado,2020,General,ADAMS,7253001139,391,15,406,352,86.70%
Colorado,2020,General,ADAMS,7253001142,1134,60,1194,1020,85.43%
Colorado,2020,General,ADAMS,7253001143,1145,56,1201,967,80.52%
Colorado,2020,General,ADAMS,7253001144,1539,151,1690,1301,76.98%
Colorado,2020,General,ADAMS,7253001148,1039,113,1152,890,77.26%
Colorado,2020,General,ADAMS,7253101106,1933,283,2216,1554,70.13%
Colorado,2020,General,ADAMS,7253101107,1587,141,1728,1304,75.46%
Colorado,2020,General,ADAMS,7253101108,1702,175,1877,1334,71.07%
Colorado,2020,General,ADAMS,7253101109,1370,102,1472,1131,76.83%
Colorado,2020,General,ADAMS,7253101110,1034,69,1103,827,74.98%
Colorado,2020,General,ADAMS,7253101111,1338,109,1447,1073,74.15%
Colorado,2020,General,ADAMS,7253101112,1260,95,1355,972,71.73%
Colorado,2020,General,ADAMS,7253101113,1375,111,1486,1078,72.54%
Colorado,2020,General,ADAMS,7253101114,1200,134,1334,947,70.99%
Colorado,2020,General,ADAMS,7253101115,1289,115,1404,999,71.15%
Colorado,2020,General,ADAMS,7253101116,791,106,897,624,69.57%
Colorado,2020,General,ADAMS,7253101133,1602,113,1715,1296,75.57%
Colorado,2020,General,ADAMS,7253101250,1091,352,1443,661,45.81%
Colorado,2020,General,ADAMS,7253401028,1099,127,1226,835,68.11%
Colorado,2020,General,ADAMS,7253401029,1625,217,1842,1189,64.55%
Colorado,2020,General,ALAMOSA,3356202001,831,149,980,679,69.29%
Colorado,2020,General,ALAMOSA,3356202002,768,297,1065,640,60.09%
Colorado,2020,General,ALAMOSA,3356202003,1665,228,1893,1422,75.12%
Colorado,2020,General,ALAMOSA,3356202004,1872,136,2008,1584,78.88%
Colorado,2020,General,ALAMOSA,3356202005,764,84,848,671,79.13%
Colorado,2020,General,ALAMOSA,3356202006,1041,181,1222,782,63.99%
Colorado,2020,General,ALAMOSA,3356202007,1829,268,2097,1441,68.72%
Colorado,2020,General,ALAMOSA,3356202008,776,47,823,704,85.54%
Colorado,2020,General,ARAPAHOE,1260303101,1470,155,1625,1121,68.98%
Colorado,2020,General,ARAPAHOE,1260303102,1303,247,1550,1035,66.77%
Colorado,2020,General,ARAPAHOE,1260303103,779,85,864,599,69.33%
Colorado,2020,General,ARAPAHOE,1260303104,773,76,849,568,66.90%
Colorado,2020,General,ARAPAHOE,1260303105,1701,206,1907,1482,77.71%
Colorado,2020,General,ARAPAHOE,1260303106,627,159,786,547,69.59%
Colorado,2020,General,ARAPAHOE,1260303107,970,144,1114,854,76.66%
Colorado,2020,General,ARAPAHOE,1260303108,727,63,790,658,83.29%
Colorado,2020,General,ARAPAHOE,1260303109,679,43,722,636,88.09%
Colorado,2020,General,ARAPAHOE,1260303110,529,27,556,501,90.11%
Colorado,2020,General,ARAPAHOE,1260303111,1367,222,1589,1132,71.24%
Colorado,2020,General,ARAPAHOE,1260303112,952,99,1051,852,81.07%
Colorado,2020,General,ARAPAHOE,1260303113,700,58,758,646,85.22%
Colorado,2020,General,ARAPAHOE,1260303114,1000,266,1266,837,66.11%
Colorado,2020,General,ARAPAHOE,1260303115,1171,175,1346,1008,74.89%
Colorado,2020,General,ARAPAHOE,1260303116,1329,168,1497,1136,75.89%
Colorado,2020,General,ARAPAHOE,1260303117,1389,305,1694,1127,66.53%
Colorado,2020,General,ARAPAHOE,1260303118,891,72,963,793,82.35%
Colorado,2020,General,ARAPAHOE,1260303119,918,77,995,784,78.79%
Colorado,2020,General,ARAPAHOE,1260303120,788,112,900,683,75.89%
Colorado,2020,General,ARAPAHOE,1260303121,608,57,665,535,80.45%
Colorado,2020,General,ARAPAHOE,1260303122,827,72,899,688,76.53%
Colorado,2020,General,ARAPAHOE,1260303123,1041,101,1142,903,79.07%
Colorado,2020,General,ARAPAHOE,1260303124,1161,189,1350,992,73.48%
Colorado,2020,General,ARAPAHOE,1260303125,665,199,864,541,62.62%
Colorado,2020,General,ARAPAHOE,1260303129,663,41,704,605,85.94%
Colorado,2020,General,ARAPAHOE,1260303130,1048,105,1153,907,78.66%
Colorado,2020,General,ARAPAHOE,1260303131,1040,52,1092,979,89.65%
Colorado,2020,General,ARAPAHOE,1260303132,1084,57,1141,1002,87.82%
Colorado,2020,General,ARAPAHOE,1260303133,1013,66,1079,933,86.47%
Colorado,2020,General,ARAPAHOE,1260303134,583,30,613,535,87.28%
Colorado,2020,General,ARAPAHOE,1260303135,399,24,423,373,88.18%
Colorado,2020,General,ARAPAHOE,1260303136,896,32,928,856,92.24%
Colorado,2020,General,ARAPAHOE,1260303140,508,30,538,447,83.09%
Colorado,2020,General,ARAPAHOE,1263803141,494,7,501,466,93.01%
Colorado,2020,General,ARAPAHOE,1310903137,936,69,1005,875,87.06%
Colorado,2020,General,ARAPAHOE,1310903138,432,36,468,394,84.19%
Colorado,2020,General,ARAPAHOE,1310903139,730,47,777,673,86.62%
Colorado,2020,General,ARAPAHOE,1310903475,31,0,31,30,96.77%
Colorado,2020,General,ARAPAHOE,1310903501,1473,412,1885,1244,65.99%
Colorado,2020,General,ARAPAHOE,1310903502,1319,466,1785,1105,61.90%
Colorado,2020,General,ARAPAHOE,4283603350,12,1,13,0,0.00%
Colorado,2020,General,ARAPAHOE,4293603358,15,6,21,12,57.14%
Colorado,2020,General,ARAPAHOE,4293603361,2,2,4,0,0.00%
Colorado,2020,General,ARAPAHOE,4295603357,3,0,3,0,0.00%
Colorado,2020,General,ARAPAHOE,4295603362,1208,91,1299,1061,81.68%
Colorado,2020,General,ARAPAHOE,4295603363,1314,132,1446,1153,79.74%
Colorado,2020,General,ARAPAHOE,4295603364,1542,157,1699,1320,77.69%
Colorado,2020,General,ARAPAHOE,4295603365,913,82,995,752,75.58%
Colorado,2020,General,ARAPAHOE,4295603366,1008,89,1097,916,83.50%
Colorado,2020,General,ARAPAHOE,6260303126,848,198,1046,615,58.80%
Colorado,2020,General,ARAPAHOE,6260303127,137,34,171,109,63.74%
Colorado,2020,General,ARAPAHOE,6260303128,476,26,502,416,82.87%
Colorado,2020,General,ARAPAHOE,6260303143,825,113,938,710,75.69%
Colorado,2020,General,ARAPAHOE,6260303153,1517,283,1800,1316,73.11%
Colorado,2020,General,ARAPAHOE,6260303161,791,109,900,701,77.89%
Colorado,2020,General,ARAPAHOE,6260303162,882,147,1029,742,72.11%
Colorado,2020,General,ARAPAHOE,6260303201,392,17,409,360,88.02%
Colorado,2020,General,ARAPAHOE,6260303202,385,14,399,356,89.22%
Colorado,2020,General,ARAPAHOE,6260303203,761,47,808,714,88.37%
Colorado,2020,General,ARAPAHOE,6260303204,1643,69,1712,1507,88.03%
Colorado,2020,General,ARAPAHOE,6260303229,1192,84,1276,1085,85.03%
Colorado,2020,General,ARAPAHOE,6260303231,1284,322,1606,1131,70.42%
Colorado,2020,General,ARAPAHOE,6260303232,1632,250,1882,1474,78.32%
Colorado,2020,General,ARAPAHOE,6260303234,1383,190,1573,1258,79.97%
Colorado,2020,General,ARAPAHOE,6260303249,842,37,879,793,90.22%
Colorado,2020,General,ARAPAHOE,6260303253,1675,97,1772,1509,85.16%
Colorado,2020,General,ARAPAHOE,6260303254,456,24,480,417,86.88%
Colorado,2020,General,ARAPAHOE,6263803142,956,71,1027,878,85.49%
Colorado,2020,General,ARAPAHOE,6263803144,814,32,846,748,88.42%
Colorado,2020,General,ARAPAHOE,6263803145,727,69,796,641,80.53%
Colorado,2020,General,ARAPAHOE,6263803146,853,27,880,793,90.11%
Colorado,2020,General,ARAPAHOE,6263803147,902,74,976,827,84.73%
Colorado,2020,General,ARAPAHOE,6263803148,612,28,640,568,88.75%
Colorado,2020,General,ARAPAHOE,6263803149,1264,43,1307,1181,90.36%
Colorado,2020,General,ARAPAHOE,6263803150,1331,231,1562,1186,75.93%
Colorado,2020,General,ARAPAHOE,6263803151,1014,183,1197,879,73.43%
Colorado,2020,General,ARAPAHOE,6263803152,877,75,952,822,86.34%
Colorado,2020,General,ARAPAHOE,6263803154,1179,138,1317,1058,80.33%
Colorado,2020,General,ARAPAHOE,6263803155,1263,58,1321,1155,87.43%
Colorado,2020,General,ARAPAHOE,6263803156,481,23,504,450,89.29%
Colorado,2020,General,ARAPAHOE,6263803157,722,24,746,690,92.49%
Colorado,2020,General,ARAPAHOE,6263803158,929,88,1017,845,83.09%
Colorado,2020,General,ARAPAHOE,6263803159,757,93,850,665,78.24%
Colorado,2020,General,ARAPAHOE,6263803160,939,95,1034,816,78.92%
Colorado,2020,General,ARAPAHOE,6263803163,821,66,887,731,82.41%
Colorado,2020,General,ARAPAHOE,6263803165,1052,68,1120,947,84.55%
Colorado,2020,General,ARAPAHOE,6263803166,465,40,505,425,84.16%
Colorado,2020,General,ARAPAHOE,6263803167,947,71,1018,847,83.20%
Colorado,2020,General,ARAPAHOE,6263803168,951,45,996,899,90.26%
Colorado,2020,General,ARAPAHOE,6263803169,1074,65,1139,992,87.09%
Colorado,2020,General,ARAPAHOE,6263803170,1369,258,1627,1192,73.26%
Colorado,2020,General,ARAPAHOE,6263803171,1497,96,1593,1396,87.63%
Colorado,2020,General,ARAPAHOE,6263803172,840,70,910,774,85.05%
Colorado,2020,General,ARAPAHOE,6263803173,1192,63,1255,1089,86.77%
Colorado,2020,General,ARAPAHOE,6263803174,730,87,817,666,81.52%
Colorado,2020,General,ARAPAHOE,6263803175,1004,109,1113,913,82.03%
Colorado,2020,General,ARAPAHOE,6263803176,1410,129,1539,1315,85.45%
Colorado,2020,General,ARAPAHOE,6264003255,1259,237,1496,1097,73.33%
Colorado,2020,General,ARAPAHOE,6264003258,514,122,636,402,63.21%
Colorado,2020,General,ARAPAHOE,6264003323,42,2,44,41,93.18%
Colorado,2020,General,ARAPAHOE,6264003453,570,26,596,516,86.58%
Colorado,2020,General,ARAPAHOE,6264003455,887,45,932,787,84.44%
Colorado,2020,General,ARAPAHOE,6264103401,1402,250,1652,1131,68.46%
Colorado,2020,General,ARAPAHOE,6264103403,862,221,1083,730,67.41%
Colorado,2020,General,ARAPAHOE,6264103404,928,223,1151,702,60.99%
Colorado,2020,General,ARAPAHOE,6264103405,1003,230,1233,776,62.94%
Colorado,2020,General,ARAPAHOE,6264103406,525,102,627,421,67.15%
Colorado,2020,General,ARAPAHOE,6264103407,1443,251,1694,1239,73.14%
Colorado,2020,General,ARAPAHOE,6264103408,860,97,957,737,77.01%
Colorado,2020,General,ARAPAHOE,6264103409,1636,315,1951,1345,68.94%
Colorado,2020,General,ARAPAHOE,6264103410,1242,135,1377,1130,82.06%
Colorado,2020,General,ARAPAHOE,6264103411,1580,389,1969,1268,64.40%
Colorado,2020,General,ARAPAHOE,6264103412,1630,362,1992,1296,65.06%
Colorado,2020,General,ARAPAHOE,6264103413,1217,308,1525,984,64.52%
Colorado,2020,General,ARAPAHOE,6264103414,959,129,1088,791,72.70%
Colorado,2020,General,ARAPAHOE,6264103416,1667,207,1874,1372,73.21%
Colorado,2020,General,ARAPAHOE,6264103417,1154,154,1308,953,72.86%
Colorado,2020,General,ARAPAHOE,6264103418,942,69,1011,826,81.70%
Colorado,2020,General,ARAPAHOE,6264103419,1116,83,1199,971,80.98%
Colorado,2020,General,ARAPAHOE,6264103423,1508,124,1632,1308,80.15%
Colorado,2020,General,ARAPAHOE,6264103425,1433,119,1552,1254,80.80%
Colorado,2020,General,ARAPAHOE,6264103426,749,63,812,667,82.14%
Colorado,2020,General,ARAPAHOE,6264103442,740,71,811,697,85.94%
Colorado,2020,General,ARAPAHOE,6264103443,546,15,561,523,93.23%
Colorado,2020,General,ARAPAHOE,6270303245,502,20,522,470,90.04%
Colorado,2020,General,ARAPAHOE,6270303246,1129,124,1253,1028,82.04%
Colorado,2020,General,ARAPAHOE,6270303247,1631,243,1874,1425,76.04%
Colorado,2020,General,ARAPAHOE,6270303248,674,113,787,586,74.46%
Colorado,2020,General,ARAPAHOE,6270303250,1037,58,1095,971,88.68%
Colorado,2020,General,ARAPAHOE,6270303251,1532,74,1606,1421,88.48%
Colorado,2020,General,ARAPAHOE,6270303252,1448,79,1527,1339,87.69%
Colorado,2020,General,ARAPAHOE,6273603335,1690,127,1817,1459,80.30%
Colorado,2020,General,ARAPAHOE,6273603336,1585,158,1743,1367,78.43%
Colorado,2020,General,ARAPAHOE,6273603337,1446,204,1650,1231,74.61%
Colorado,2020,General,ARAPAHOE,6273603368,723,168,891,570,63.97%
Colorado,2020,General,ARAPAHOE,6273703218,972,120,1092,867,79.40%
Colorado,2020,General,ARAPAHOE,6273703220,908,62,970,834,85.98%
Colorado,2020,General,ARAPAHOE,6273703221,822,64,886,761,85.89%
Colorado,2020,General,ARAPAHOE,6273703222,920,30,950,857,90.21%
Colorado,2020,General,ARAPAHOE,6273703223,1028,141,1169,916,78.36%
Colorado,2020,General,ARAPAHOE,6273703224,877,67,944,798,84.53%
Colorado,2020,General,ARAPAHOE,6273703225,981,48,1029,910,88.44%
Colorado,2020,General,ARAPAHOE,6273703226,719,49,768,676,88.02%
Colorado,2020,General,ARAPAHOE,6273703227,702,43,745,663,88.99%
Colorado,2020,General,ARAPAHOE,6273703228,855,40,895,786,87.82%
Colorado,2020,General,ARAPAHOE,6273703233,863,251,1114,718,64.45%
Colorado,2020,General,ARAPAHOE,6273703235,731,60,791,662,83.69%
Colorado,2020,General,ARAPAHOE,6273703236,697,52,749,633,84.51%
Colorado,2020,General,ARAPAHOE,6273703237,1228,75,1303,1119,85.88%
Colorado,2020,General,ARAPAHOE,6273703238,869,77,946,792,83.72%
Colorado,2020,General,ARAPAHOE,6273703239,881,67,948,828,87.34%
Colorado,2020,General,ARAPAHOE,6273703240,1644,150,1794,1518,84.62%
Colorado,2020,General,ARAPAHOE,6273703241,1054,81,1135,992,87.40%
Colorado,2020,General,ARAPAHOE,6273703242,740,29,769,701,91.16%
Colorado,2020,General,ARAPAHOE,6273703243,1427,322,1749,1137,65.01%
Colorado,2020,General,ARAPAHOE,6273703244,1265,125,1390,1147,82.52%
Colorado,2020,General,ARAPAHOE,6273703257,1301,91,1392,1129,81.11%
Colorado,2020,General,ARAPAHOE,6273703259,2057,453,2510,1613,64.26%
Colorado,2020,General,ARAPAHOE,6273703260,1640,223,1863,1442,77.40%
Colorado,2020,General,ARAPAHOE,6273703261,1526,105,1631,1361,83.45%
Colorado,2020,General,ARAPAHOE,6273703262,1294,83,1377,1168,84.82%
Colorado,2020,General,ARAPAHOE,6273703263,1066,64,1130,981,86.81%
Colorado,2020,General,ARAPAHOE,6273703264,1252,85,1337,1124,84.07%
Colorado,2020,General,ARAPAHOE,6273703274,1205,110,1315,1089,82.81%
Colorado,2020,General,ARAPAHOE,6273703275,673,63,736,588,79.89%
Colorado,2020,General,ARAPAHOE,6273703276,331,30,361,275,76.18%
Colorado,2020,General,ARAPAHOE,6273703277,894,118,1012,797,78.75%
Colorado,2020,General,ARAPAHOE,6273703278,523,47,570,460,80.70%
Colorado,2020,General,ARAPAHOE,6273703279,960,57,1017,855,84.07%
Colorado,2020,General,ARAPAHOE,6273703280,1236,80,1316,1088,82.67%
Colorado,2020,General,ARAPAHOE,6273703281,1215,94,1309,1090,83.27%
Colorado,2020,General,ARAPAHOE,6273703282,1524,147,1671,1334,79.83%
Colorado,2020,General,ARAPAHOE,6273703283,941,47,988,842,85.22%
Colorado,2020,General,ARAPAHOE,6273703284,783,162,945,640,67.72%
Colorado,2020,General,ARAPAHOE,6273703285,793,50,843,739,87.66%
Colorado,2020,General,ARAPAHOE,6273703286,1933,436,2369,1700,71.76%
Colorado,2020,General,ARAPAHOE,6273703320,1792,164,1956,1529,78.17%
Colorado,2020,General,ARAPAHOE,6273703321,1360,119,1479,1193,80.66%
Colorado,2020,General,ARAPAHOE,6273703322,1199,71,1270,1076,84.72%
Colorado,2020,General,ARAPAHOE,6273703324,587,31,618,548,88.67%
Colorado,2020,General,ARAPAHOE,6273703325,1761,105,1866,1618,86.71%
Colorado,2020,General,ARAPAHOE,6273703328,301,17,318,274,86.16%
Colorado,2020,General,ARAPAHOE,6273703331,707,55,762,646,84.78%
Colorado,2020,General,ARAPAHOE,6273703332,1139,104,1243,984,79.16%
Colorado,2020,General,ARAPAHOE,6273703333,862,107,969,759,78.33%
Colorado,2020,General,ARAPAHOE,6273703334,1880,195,2075,1663,80.14%
Colorado,2020,General,ARAPAHOE,6273703338,988,106,1094,870,79.52%
Colorado,2020,General,ARAPAHOE,6273703339,1312,136,1448,1156,79.83%
Colorado,2020,General,ARAPAHOE,6273703367,1346,77,1423,1228,86.30%
Colorado,2020,General,ARAPAHOE,6273803164,799,78,877,701,79.93%
Colorado,2020,General,ARAPAHOE,6273803177,1019,65,1084,927,85.52%
Colorado,2020,General,ARAPAHOE,6273803178,891,91,982,791,80.55%
Colorado,2020,General,ARAPAHOE,6273803179,735,54,789,648,82.13%
Colorado,2020,General,ARAPAHOE,6273803180,791,34,825,719,87.15%
Colorado,2020,General,ARAPAHOE,6273803181,760,62,822,681,82.85%
Colorado,2020,General,ARAPAHOE,6273803182,1003,56,1059,907,85.65%
Colorado,2020,General,ARAPAHOE,6273803183,1405,124,1529,1286,84.11%
Colorado,2020,General,ARAPAHOE,6273803184,733,43,776,684,88.14%
Colorado,2020,General,ARAPAHOE,6273803185,947,96,1043,847,81.21%
Colorado,2020,General,ARAPAHOE,6273803186,967,52,1019,905,88.81%
Colorado,2020,General,ARAPAHOE,6273803187,949,51,1000,864,86.40%
Colorado,2020,General,ARAPAHOE,6273803188,657,37,694,609,87.75%
Colorado,2020,General,ARAPAHOE,6273803189,1126,55,1181,1048,88.74%
Colorado,2020,General,ARAPAHOE,6273803190,1287,113,1400,1146,81.86%
Colorado,2020,General,ARAPAHOE,6273803191,1140,51,1191,1078,90.51%
Colorado,2020,General,ARAPAHOE,6273803192,1058,61,1119,994,88.83%
Colorado,2020,General,ARAPAHOE,6273803193,896,69,965,809,83.83%
Colorado,2020,General,ARAPAHOE,6273803194,1194,71,1265,1102,87.11%
Colorado,2020,General,ARAPAHOE,6273803195,1024,30,1054,968,91.84%
Colorado,2020,General,ARAPAHOE,6273803196,645,29,674,601,89.17%
Colorado,2020,General,ARAPAHOE,6273803197,737,38,775,703,90.71%
Colorado,2020,General,ARAPAHOE,6273803205,707,41,748,641,85.70%
Colorado,2020,General,ARAPAHOE,6273803206,815,36,851,753,88.48%
Colorado,2020,General,ARAPAHOE,6273803207,1200,71,1271,1094,86.07%
Colorado,2020,General,ARAPAHOE,6273803208,1144,89,1233,1046,84.83%
Colorado,2020,General,ARAPAHOE,6273803209,1013,37,1050,948,90.29%
Colorado,2020,General,ARAPAHOE,6273803210,1564,100,1664,1414,84.98%
Colorado,2020,General,ARAPAHOE,6273803211,932,75,1007,826,82.03%
Colorado,2020,General,ARAPAHOE,6273803212,1295,133,1428,1139,79.76%
Colorado,2020,General,ARAPAHOE,6273803213,1048,99,1147,938,81.78%
Colorado,2020,General,ARAPAHOE,6273803214,861,43,904,798,88.27%
Colorado,2020,General,ARAPAHOE,6273803215,689,36,725,646,89.10%
Colorado,2020,General,ARAPAHOE,6273803216,954,48,1002,890,88.82%
Colorado,2020,General,ARAPAHOE,6273803217,863,35,898,814,90.65%
Colorado,2020,General,ARAPAHOE,6273803219,1167,49,1216,1099,90.38%
Colorado,2020,General,ARAPAHOE,6274003457,0,3,3,0,0.00%
Colorado,2020,General,ARAPAHOE,6283603318,1035,101,1136,896,78.87%
Colorado,2020,General,ARAPAHOE,6283603340,2683,165,2848,2412,84.69%
Colorado,2020,General,ARAPAHOE,6283603341,1802,176,1978,1587,80.23%
Colorado,2020,General,ARAPAHOE,6283603342,1877,185,2062,1608,77.98%
Colorado,2020,General,ARAPAHOE,6283603343,1343,93,1436,1172,81.62%
Colorado,2020,General,ARAPAHOE,6283603344,1675,129,1804,1462,81.04%
Colorado,2020,General,ARAPAHOE,6283603351,1954,167,2121,1701,80.20%
Colorado,2020,General,ARAPAHOE,6283603369,1380,109,1489,1175,78.91%
Colorado,2020,General,ARAPAHOE,6283603370,1622,139,1761,1412,80.18%
Colorado,2020,General,ARAPAHOE,6283603371,998,101,1099,850,77.34%
Colorado,2020,General,ARAPAHOE,6283603372,1832,203,2035,1611,79.16%
Colorado,2020,General,ARAPAHOE,6284003265,1107,151,1258,898,71.38%
Colorado,2020,General,ARAPAHOE,6284003266,1143,140,1283,962,74.98%
Colorado,2020,General,ARAPAHOE,6284003267,1102,130,1232,941,76.38%
Colorado,2020,General,ARAPAHOE,6284003268,912,92,1004,796,79.28%
Colorado,2020,General,ARAPAHOE,6284003269,1083,160,1243,887,71.36%
Colorado,2020,General,ARAPAHOE,6284003270,949,136,1085,758,69.86%
Colorado,2020,General,ARAPAHOE,6284003271,797,85,882,659,74.72%
Colorado,2020,General,ARAPAHOE,6284003272,860,71,931,746,80.13%
Colorado,2020,General,ARAPAHOE,6284003273,924,96,1020,782,76.67%
Colorado,2020,General,ARAPAHOE,6284003302,1248,111,1359,1081,79.54%
Colorado,2020,General,ARAPAHOE,6284003303,935,53,988,803,81.28%
Colorado,2020,General,ARAPAHOE,6284003304,942,105,1047,781,74.59%
Colorado,2020,General,ARAPAHOE,6284003305,1341,152,1493,1145,76.69%
Colorado,2020,General,ARAPAHOE,6284003306,846,90,936,717,76.60%
Colorado,2020,General,ARAPAHOE,6284003307,766,273,1039,550,52.94%
Colorado,2020,General,ARAPAHOE,6284003308,1236,155,1391,1056,75.92%
Colorado,2020,General,ARAPAHOE,6284003309,1290,167,1457,1074,73.71%
Colorado,2020,General,ARAPAHOE,6284003310,1900,167,2067,1572,76.05%
Colorado,2020,General,ARAPAHOE,6284003311,1870,159,2029,1623,79.99%
Colorado,2020,General,ARAPAHOE,6284003312,1787,215,2002,1501,74.98%
Colorado,2020,General,ARAPAHOE,6284003313,1127,102,1229,934,76.00%
Colorado,2020,General,ARAPAHOE,6284003314,875,57,932,756,81.12%
Colorado,2020,General,ARAPAHOE,6284003315,1574,171,1745,1361,77.99%
Colorado,2020,General,ARAPAHOE,6284003316,804,65,869,680,78.25%
Colorado,2020,General,ARAPAHOE,6284003317,1073,143,1216,889,73.11%
Colorado,2020,General,ARAPAHOE,6284003319,1846,171,2017,1514,75.06%
Colorado,2020,General,ARAPAHOE,6284003446,810,72,882,727,82.43%
Colorado,2020,General,ARAPAHOE,6284003447,1041,124,1165,845,72.53%
Colorado,2020,General,ARAPAHOE,6284003448,1754,273,2027,1508,74.40%
Colorado,2020,General,ARAPAHOE,6284003449,767,93,860,677,78.72%
Colorado,2020,General,ARAPAHOE,6284003450,1300,251,1551,1064,68.60%
Colorado,2020,General,ARAPAHOE,6284003451,1246,159,1405,1060,75.44%
Colorado,2020,General,ARAPAHOE,6284003452,884,84,968,766,79.13%
Colorado,2020,General,ARAPAHOE,6284003454,1111,80,1191,962,80.77%
Colorado,2020,General,ARAPAHOE,6284003456,1219,89,1308,1033,78.98%
Colorado,2020,General,ARAPAHOE,6284003459,926,94,1020,773,75.78%
Colorado,2020,General,ARAPAHOE,6284003460,1155,142,1297,988,76.18%
Colorado,2020,General,ARAPAHOE,6284003461,1303,145,1448,1105,76.31%
Colorado,2020,General,ARAPAHOE,6284003462,1208,99,1307,1058,80.95%
Colorado,2020,General,ARAPAHOE,6284003463,1473,115,1588,1281,80.67%
Colorado,2020,General,ARAPAHOE,6284003464,926,114,1040,774,74.42%
Colorado,2020,General,ARAPAHOE,6284003472,1363,296,1659,1041,62.75%
Colorado,2020,General,ARAPAHOE,6284003473,1648,271,1919,1301,67.80%
Colorado,2020,General,ARAPAHOE,6284103301,686,63,749,578,77.17%
Colorado,2020,General,ARAPAHOE,6284103420,1759,207,1966,1454,73.96%
Colorado,2020,General,ARAPAHOE,6284103421,553,29,582,506,86.94%
Colorado,2020,General,ARAPAHOE,6284103422,709,72,781,595,76.18%
Colorado,2020,General,ARAPAHOE,6284103427,1550,177,1727,1333,77.19%
Colorado,2020,General,ARAPAHOE,6284103428,1102,136,1238,938,75.77%
Colorado,2020,General,ARAPAHOE,6284103429,931,220,1151,757,65.77%
Colorado,2020,General,ARAPAHOE,6284103430,1166,189,1355,974,71.88%
Colorado,2020,General,ARAPAHOE,6284103431,644,47,691,549,79.45%
Colorado,2020,General,ARAPAHOE,6284103432,1298,212,1510,1008,66.75%
Colorado,2020,General,ARAPAHOE,6284103433,987,123,1110,774,69.73%
Colorado,2020,General,ARAPAHOE,6284103437,1437,140,1577,1190,75.46%
Colorado,2020,General,ARAPAHOE,6284103438,1399,160,1559,1148,73.64%
Colorado,2020,General,ARAPAHOE,6284103439,981,85,1066,827,77.58%
Colorado,2020,General,ARAPAHOE,6284103440,838,56,894,810,90.60%
Colorado,2020,General,ARAPAHOE,6284103441,847,41,888,804,90.54%
Colorado,2020,General,ARAPAHOE,6284103444,665,47,712,580,81.46%
Colorado,2020,General,ARAPAHOE,6284103445,720,82,802,617,76.93%
Colorado,2020,General,ARAPAHOE,6284103465,691,70,761,585,76.87%
Colorado,2020,General,ARAPAHOE,6284103466,942,96,1038,774,74.57%
Colorado,2020,General,ARAPAHOE,6284103467,971,93,1064,815,76.60%
Colorado,2020,General,ARAPAHOE,6284103468,895,87,982,749,76.27%
Colorado,2020,General,ARAPAHOE,6284103469,763,154,917,596,64.99%
Colorado,2020,General,ARAPAHOE,6284103470,1245,238,1483,973,65.61%
Colorado,2020,General,ARAPAHOE,6284103471,1089,95,1184,876,73.99%
Colorado,2020,General,ARAPAHOE,6284203434,1194,188,1382,970,70.19%
Colorado,2020,General,ARAPAHOE,6284203435,1419,203,1622,1095,67.51%
Colorado,2020,General,ARAPAHOE,6284203436,1442,263,1705,1127,66.10%
Colorado,2020,General,ARAPAHOE,6285603352,1463,279,1742,1203,69.06%
Colorado,2020,General,ARAPAHOE,6285603373,1451,102,1553,1326,85.38%
Colorado,2020,General,ARAPAHOE,6285603378,1561,151,1712,1390,81.19%
Colorado,2020,General,ARAPAHOE,6293603345,500,39,539,453,84.04%
Colorado,2020,General,ARAPAHOE,6293603346,1559,159,1718,1337,77.82%
Colorado,2020,General,ARAPAHOE,6293603347,1401,130,1531,1215,79.36%
Colorado,2020,General,ARAPAHOE,6293603360,979,89,1068,745,69.76%
Colorado,2020,General,ARAPAHOE,6293603374,1808,229,2037,1545,75.85%
Colorado,2020,General,ARAPAHOE,6293603381,1787,152,1939,1571,81.02%
Colorado,2020,General,ARAPAHOE,6293603474,780,101,881,591,67.08%
Colorado,2020,General,ARAPAHOE,6293603537,1193,191,1384,949,68.57%
Colorado,2020,General,ARAPAHOE,6293603538,1196,119,1315,973,73.99%
Colorado,2020,General,ARAPAHOE,6293603539,1204,192,1396,944,67.62%
Colorado,2020,General,ARAPAHOE,6293603540,716,60,776,567,73.07%
Colorado,2020,General,ARAPAHOE,6293603541,727,90,817,601,73.56%
Colorado,2020,General,ARAPAHOE,6293603542,864,270,1134,554,48.85%
Colorado,2020,General,ARAPAHOE,6293603543,988,102,1090,830,76.15%
Colorado,2020,General,ARAPAHOE,6293603544,1399,344,1743,1031,59.15%
Colorado,2020,General,ARAPAHOE,6293603545,393,137,530,279,52.64%
Colorado,2020,General,ARAPAHOE,6293603546,1114,149,1263,882,69.83%
Colorado,2020,General,ARAPAHOE,6293603547,1093,104,1197,851,71.09%
Colorado,2020,General,ARAPAHOE,6293603548,499,169,668,330,49.40%
Colorado,2020,General,ARAPAHOE,6293603549,554,116,670,378,56.42%
Colorado,2020,General,ARAPAHOE,6293603550,72,23,95,64,67.37%
Colorado,2020,General,ARAPAHOE,6293603551,832,248,1080,604,55.93%
Colorado,2020,General,ARAPAHOE,6293603552,1034,218,1252,746,59.58%
Colorado,2020,General,ARAPAHOE,6293603553,1464,197,1661,1166,70.20%
Colorado,2020,General,ARAPAHOE,6293603554,1122,150,1272,945,74.29%
Colorado,2020,General,ARAPAHOE,6293603555,910,140,1050,743,70.76%
Colorado,2020,General,ARAPAHOE,6293603556,1277,141,1418,1038,73.20%
Colorado,2020,General,ARAPAHOE,6293603557,1730,220,1950,1438,73.74%
Colorado,2020,General,ARAPAHOE,6293603558,1082,128,1210,874,72.23%
Colorado,2020,General,ARAPAHOE,6293603559,875,135,1010,724,71.68%
Colorado,2020,General,ARAPAHOE,6293603560,499,69,568,396,69.72%
Colorado,2020,General,ARAPAHOE,6294203503,1819,333,2152,1308,60.78%
Colorado,2020,General,ARAPAHOE,6294203504,1060,145,1205,781,64.81%
Colorado,2020,General,ARAPAHOE,6294203505,1009,265,1274,712,55.89%
Colorado,2020,General,ARAPAHOE,6294203506,1635,406,2041,1083,53.06%
Colorado,2020,General,ARAPAHOE,6294203507,907,123,1030,658,63.88%
Colorado,2020,General,ARAPAHOE,6294203508,716,98,814,531,65.23%
Colorado,2020,General,ARAPAHOE,6294203509,679,60,739,548,74.15%
Colorado,2020,General,ARAPAHOE,6294203510,687,52,739,600,81.19%
Colorado,2020,General,ARAPAHOE,6294203511,989,298,1287,752,58.43%
Colorado,2020,General,ARAPAHOE,6294203512,1076,223,1299,805,61.97%
Colorado,2020,General,ARAPAHOE,6294203513,1004,207,1211,793,65.48%
Colorado,2020,General,ARAPAHOE,6294203514,856,204,1060,616,58.11%
Colorado,2020,General,ARAPAHOE,6294203515,1032,73,1105,835,75.57%
Colorado,2020,General,ARAPAHOE,6294203516,801,87,888,638,71.85%
Colorado,2020,General,ARAPAHOE,6294203517,813,82,895,652,72.85%
Colorado,2020,General,ARAPAHOE,6294203518,751,126,877,574,65.45%
Colorado,2020,General,ARAPAHOE,6294203519,884,170,1054,601,57.02%
Colorado,2020,General,ARAPAHOE,6294203520,981,86,1067,810,75.91%
Colorado,2020,General,ARAPAHOE,6294203521,853,111,964,663,68.78%
Colorado,2020,General,ARAPAHOE,6294203522,1072,119,1191,845,70.95%
Colorado,2020,General,ARAPAHOE,6294203523,1346,175,1521,1103,72.52%
Colorado,2020,General,ARAPAHOE,6294203524,1000,167,1167,717,61.44%
Colorado,2020,General,ARAPAHOE,6294203525,916,173,1089,698,64.10%
Colorado,2020,General,ARAPAHOE,6294203526,884,107,991,681,68.72%
Colorado,2020,General,ARAPAHOE,6294203527,1146,224,1370,840,61.31%
Colorado,2020,General,ARAPAHOE,6294203528,508,114,622,348,55.95%
Colorado,2020,General,ARAPAHOE,6294203529,613,152,765,431,56.34%
Colorado,2020,General,ARAPAHOE,6294203530,1079,201,1280,735,57.42%
Colorado,2020,General,ARAPAHOE,6294203531,869,101,970,647,66.70%
Colorado,2020,General,ARAPAHOE,6294203532,1027,273,1300,833,64.08%
Colorado,2020,General,ARAPAHOE,6294203533,1392,329,1721,1043,60.60%
Colorado,2020,General,ARAPAHOE,6294203534,1003,388,1391,765,55.00%
Colorado,2020,General,ARAPAHOE,6294203535,921,84,1005,791,78.71%
Colorado,2020,General,ARAPAHOE,6294203536,793,228,1021,569,55.73%
Colorado,2020,General,ARAPAHOE,6295603326,1374,86,1460,1329,91.03%
Colorado,2020,General,ARAPAHOE,6295603327,1226,102,1328,1085,81.70%
Colorado,2020,General,ARAPAHOE,6295603329,1389,226,1615,1156,71.58%
Colorado,2020,General,ARAPAHOE,6295603330,1842,212,2054,1594,77.60%
Colorado,2020,General,ARAPAHOE,6295603353,1135,113,1248,1033,82.77%
Colorado,2020,General,ARAPAHOE,6295603354,1687,127,1814,1557,85.83%
Colorado,2020,General,ARAPAHOE,6295603355,3460,215,3675,3116,84.79%
Colorado,2020,General,ARAPAHOE,6295603356,1505,64,1569,1399,89.17%
Colorado,2020,General,ARAPAHOE,6295603375,1438,182,1620,1266,78.15%
Colorado,2020,General,ARAPAHOE,6295603376,1368,77,1445,1294,89.55%
Colorado,2020,General,ARAPAHOE,6295603377,2243,127,2370,2060,86.92%
Colorado,2020,General,ARAPAHOE,6295603379,982,90,1072,881,82.18%
Colorado,2020,General,ARAPAHOE,6295603380,1000,81,1081,904,83.63%
Colorado,2020,General,ARCHULETA,3065904001,1199,129,1328,1029,77.48%
Colorado,2020,General,ARCHULETA,3065904002,1053,107,1160,910,78.45%
Colorado,2020,General,ARCHULETA,3065904003,851,106,957,758,79.21%
Colorado,2020,General,ARCHULETA,3065904004,458,40,498,395,79.32%
Colorado,2020,General,ARCHULETA,3065904005,1248,166,1414,1025,72.49%
Colorado,2020,General,ARCHULETA,3065904006,1882,261,2143,1692,78.95%
Colorado,2020,General,ARCHULETA,3065904007,1850,351,2201,1634,74.24%
Colorado,2020,General,ARCHULETA,3065904008,2066,257,2323,1794,77.23%
Colorado,2020,General,BACA,4356405001,302,29,331,260,78.55%
Colorado,2020,General,BACA,4356405002,345,46,391,290,74.17%
Colorado,2020,General,BACA,4356405003,201,15,216,176,81.48%
Colorado,2020,General,BACA,4356405004,443,52,495,357,72.12%
Colorado,2020,General,BACA,4356405005,152,18,170,128,75.29%
Colorado,2020,General,BACA,4356405006,172,26,198,153,77.27%
Colorado,2020,General,BACA,4356405007,480,68,548,413,75.36%
Colorado,2020,General,BACA,4356405008,461,56,517,386,74.66%
Colorado,2020,General,BACA,4356405009,95,4,99,82,82.83%
Colorado,2020,General,BENT,4356406001,483,114,597,412,69.01%
Colorado,2020,General,BENT,4356406002,582,65,647,500,77.28%
Colorado,2020,General,BENT,4356406003,656,140,796,500,62.81%
Colorado,2020,General,BENT,4356406004,542,128,670,406,60.60%
Colorado,2020,General,BENT,4356406005,554,75,629,477,75.83%
Colorado,2020,General,BOULDER,2161307900,518,44,562,476,84.70%
Colorado,2020,General,BOULDER,2161307901,714,62,776,651,83.89%
Colorado,2020,General,BOULDER,2161307902,312,30,342,282,82.46%
Colorado,2020,General,BOULDER,2163307100,1547,105,1652,1399,84.69%
Colorado,2020,General,BOULDER,2163307101,1385,119,1504,1296,86.17%
Colorado,2020,General,BOULDER,2163307102,1171,368,1539,1002,65.11%
Colorado,2020,General,BOULDER,2163307103,1212,66,1278,1110,86.85%
Colorado,2020,General,BOULDER,2163307104,1146,74,1220,1066,87.38%
Colorado,2020,General,BOULDER,2163307105,493,76,569,442,77.68%
Colorado,2020,General,BOULDER,2163307106,1088,62,1150,1006,87.48%
Colorado,2020,General,BOULDER,2163307107,1056,67,1123,963,85.75%
Colorado,2020,General,BOULDER,2171207200,664,40,704,621,88.21%
Colorado,2020,General,BOULDER,2171207201,712,37,749,662,88.38%
Colorado,2020,General,BOULDER,2171207202,1151,129,1280,1067,83.36%
Colorado,2020,General,BOULDER,2171207203,1034,34,1068,976,91.39%
Colorado,2020,General,BOULDER,2171207204,1004,69,1073,953,88.82%
Colorado,2020,General,BOULDER,2171207205,985,50,1035,912,88.12%
Colorado,2020,General,BOULDER,2171207206,578,25,603,550,91.21%
Colorado,2020,General,BOULDER,2171207207,989,53,1042,934,89.64%
Colorado,2020,General,BOULDER,2171207208,1109,68,1177,1052,89.38%
Colorado,2020,General,BOULDER,2171207209,627,21,648,601,92.75%
Colorado,2020,General,BOULDER,2171207210,934,64,998,895,89.68%
Colorado,2020,General,BOULDER,2171207211,1113,78,1191,1003,84.21%
Colorado,2020,General,BOULDER,2171207212,1510,136,1646,1364,82.87%
Colorado,2020,General,BOULDER,2171207213,1405,123,1528,1328,86.91%
Colorado,2020,General,BOULDER,2171207214,1267,90,1357,1185,87.32%
Colorado,2020,General,BOULDER,2171207215,907,59,966,829,85.82%
Colorado,2020,General,BOULDER,2171207300,1809,207,2016,1601,79.41%
Colorado,2020,General,BOULDER,2171207301,1690,105,1795,1464,81.56%
Colorado,2020,General,BOULDER,2171207302,1906,100,2006,1778,88.63%
Colorado,2020,General,BOULDER,2171207303,955,103,1058,856,80.91%
Colorado,2020,General,BOULDER,2171207304,970,61,1031,907,87.97%
Colorado,2020,General,BOULDER,2171207305,1155,121,1276,1029,80.64%
Colorado,2020,General,BOULDER,2171207306,1229,115,1344,1109,82.51%
Colorado,2020,General,BOULDER,2171207307,1318,201,1519,1071,70.51%
Colorado,2020,General,BOULDER,2171207308,1083,77,1160,984,84.83%
Colorado,2020,General,BOULDER,2171207309,1139,88,1227,1067,86.96%
Colorado,2020,General,BOULDER,2171207310,1496,102,1598,1380,86.36%
Colorado,2020,General,BOULDER,2171207311,860,75,935,778,83.21%
Colorado,2020,General,BOULDER,2171207312,1025,65,1090,969,88.90%
Colorado,2020,General,BOULDER,2171207313,1332,72,1404,1256,89.46%
Colorado,2020,General,BOULDER,2171207314,1492,66,1558,1415,90.82%
Colorado,2020,General,BOULDER,2171207315,856,52,908,796,87.67%
Colorado,2020,General,BOULDER,2171207316,1260,57,1317,1172,88.99%
Colorado,2020,General,BOULDER,2171207407,484,27,511,433,84.74%
Colorado,2020,General,BOULDER,2173307400,128,7,135,119,88.15%
Colorado,2020,General,BOULDER,2173307408,1414,85,1499,1285,85.72%
Colorado,2020,General,BOULDER,2173307409,1805,121,1926,1650,85.67%
Colorado,2020,General,BOULDER,2173307410,1214,51,1265,1143,90.36%
Colorado,2020,General,BOULDER,2173307411,1402,65,1467,1327,90.46%
Colorado,2020,General,BOULDER,2173307412,1353,75,1428,1238,86.69%
Colorado,2020,General,BOULDER,2173307413,1440,98,1538,1304,84.79%
Colorado,2020,General,BOULDER,2173307414,1226,23,1249,1151,92.15%
Colorado,2020,General,BOULDER,2181007500,941,91,1032,860,83.33%
Colorado,2020,General,BOULDER,2181007501,931,39,970,880,90.72%
Colorado,2020,General,BOULDER,2181007502,1044,54,1098,983,89.53%
Colorado,2020,General,BOULDER,2181007503,1518,81,1599,1410,88.18%
Colorado,2020,General,BOULDER,2181007504,750,33,783,706,90.17%
Colorado,2020,General,BOULDER,2181007800,897,56,953,846,88.77%
Colorado,2020,General,BOULDER,2181007801,856,129,985,784,79.59%
Colorado,2020,General,BOULDER,2181007802,1029,236,1265,919,72.65%
Colorado,2020,General,BOULDER,2181007803,1017,170,1187,942,79.36%
Colorado,2020,General,BOULDER,2181007804,1282,80,1362,1192,87.52%
Colorado,2020,General,BOULDER,2181007805,489,26,515,460,89.32%
Colorado,2020,General,BOULDER,2181007806,1335,171,1506,1199,79.61%
Colorado,2020,General,BOULDER,2181007807,1177,85,1262,1090,86.37%
Colorado,2020,General,BOULDER,2181007808,1813,182,1995,1599,80.15%
Colorado,2020,General,BOULDER,2181007809,1256,71,1327,1166,87.87%
Colorado,2020,General,BOULDER,2181007810,1055,55,1110,982,88.47%
Colorado,2020,General,BOULDER,2181007811,1338,62,1400,1258,89.86%
Colorado,2020,General,BOULDER,2181007812,1284,89,1373,1199,87.33%
Colorado,2020,General,BOULDER,2181007813,1020,82,1102,876,79.49%
Colorado,2020,General,BOULDER,2181007814,1167,109,1276,1080,84.64%
Colorado,2020,General,BOULDER,2181007815,852,174,1026,764,74.46%
Colorado,2020,General,BOULDER,2181007816,1197,132,1329,1101,82.84%
Colorado,2020,General,BOULDER,2181007817,827,35,862,780,90.49%
Colorado,2020,General,BOULDER,2181007818,1071,98,1169,999,85.46%
Colorado,2020,General,BOULDER,2181007819,920,104,1024,843,82.32%
Colorado,2020,General,BOULDER,2181007820,720,44,764,671,87.83%
Colorado,2020,General,BOULDER,2181007821,1089,147,1236,993,80.34%
Colorado,2020,General,BOULDER,2181007822,1877,314,2191,1602,73.12%
Colorado,2020,General,BOULDER,2181007823,1316,297,1613,1143,70.86%
Colorado,2020,General,BOULDER,2181007824,1158,124,1282,1026,80.03%
Colorado,2020,General,BOULDER,2181007825,639,70,709,604,85.19%
Colorado,2020,General,BOULDER,2181007826,888,82,970,812,83.71%
Colorado,2020,General,BOULDER,2181007827,927,156,1083,832,76.82%
Colorado,2020,General,BOULDER,2181007828,728,149,877,659,75.14%
Colorado,2020,General,BOULDER,2181007829,721,214,935,633,67.70%
Colorado,2020,General,BOULDER,2181007830,662,236,898,566,63.03%
Colorado,2020,General,BOULDER,2181007831,778,233,1011,661,65.38%
Colorado,2020,General,BOULDER,2181007832,369,56,425,300,70.59%
Colorado,2020,General,BOULDER,2181007833,602,276,878,505,57.52%
Colorado,2020,General,BOULDER,2181007834,371,576,947,314,33.16%
Colorado,2020,General,BOULDER,2181007835,233,233,466,198,42.49%
Colorado,2020,General,BOULDER,2181007836,517,81,598,446,74.58%
Colorado,2020,General,BOULDER,2181007837,779,260,1039,644,61.98%
Colorado,2020,General,BOULDER,2181007838,437,134,571,387,67.78%
Colorado,2020,General,BOULDER,2181007839,621,51,672,580,86.31%
Colorado,2020,General,BOULDER,2181007840,581,84,665,531,79.85%
Colorado,2020,General,BOULDER,2181007841,742,54,796,676,84.92%
Colorado,2020,General,BOULDER,2181007842,1163,95,1258,1076,85.53%
Colorado,2020,General,BOULDER,2181007843,1345,83,1428,1233,86.34%
Colorado,2020,General,BOULDER,2181007844,707,91,798,640,80.20%
Colorado,2020,General,BOULDER,2181007845,823,136,959,727,75.81%
Colorado,2020,General,BOULDER,2181007846,1070,294,1364,866,63.49%
Colorado,2020,General,BOULDER,2181007847,664,234,898,493,54.90%
Colorado,2020,General,BOULDER,2181007848,631,113,744,575,77.28%
Colorado,2020,General,BOULDER,2181007849,370,506,876,323,36.87%
Colorado,2020,General,BOULDER,2181007850,702,32,734,657,89.51%
Colorado,2020,General,BOULDER,2181007851,1090,93,1183,996,84.19%
Colorado,2020,General,BOULDER,2181007852,1136,155,1291,1029,79.71%
Colorado,2020,General,BOULDER,2181007853,850,161,1011,746,73.79%
Colorado,2020,General,BOULDER,2181107505,910,57,967,844,87.28%
Colorado,2020,General,BOULDER,2181107506,627,27,654,582,88.99%
Colorado,2020,General,BOULDER,2181107507,1274,57,1331,1189,89.33%
Colorado,2020,General,BOULDER,2181107508,765,31,796,718,90.20%
Colorado,2020,General,BOULDER,2181107700,941,66,1007,877,87.09%
Colorado,2020,General,BOULDER,2181107701,577,31,608,533,87.66%
Colorado,2020,General,BOULDER,2181107702,414,19,433,383,88.45%
Colorado,2020,General,BOULDER,2181107703,472,22,494,450,91.09%
Colorado,2020,General,BOULDER,2181107704,369,19,388,343,88.40%
Colorado,2020,General,BOULDER,2181107705,693,29,722,628,86.98%
Colorado,2020,General,BOULDER,2181107912,1178,91,1269,1110,87.47%
Colorado,2020,General,BOULDER,2181107913,698,33,731,653,89.33%
Colorado,2020,General,BOULDER,2181107916,512,42,554,451,81.41%
Colorado,2020,General,BOULDER,2181107917,1410,97,1507,1307,86.73%
Colorado,2020,General,BOULDER,2181107918,1237,75,1312,1134,86.43%
Colorado,2020,General,BOULDER,2181207401,751,29,780,697,89.36%
Colorado,2020,General,BOULDER,2181207402,656,22,678,614,90.56%
Colorado,2020,General,BOULDER,2181207403,975,61,1036,894,86.29%
Colorado,2020,General,BOULDER,2181207404,990,71,1061,911,85.86%
Colorado,2020,General,BOULDER,2181207405,490,31,521,454,87.14%
Colorado,2020,General,BOULDER,2181207406,758,26,784,697,88.90%
Colorado,2020,General,BOULDER,2181307854,1011,168,1179,851,72.18%
Colorado,2020,General,BOULDER,2181307855,852,162,1014,757,74.65%
Colorado,2020,General,BOULDER,2181307856,635,58,693,591,85.28%
Colorado,2020,General,BOULDER,2181307857,876,78,954,831,87.11%
Colorado,2020,General,BOULDER,2181307858,978,73,1051,933,88.77%
Colorado,2020,General,BOULDER,2181307859,863,26,889,824,92.69%
Colorado,2020,General,BOULDER,2181307860,685,31,716,646,90.22%
Colorado,2020,General,BOULDER,2181307861,630,44,674,591,87.69%
Colorado,2020,General,BOULDER,2181307862,699,36,735,651,88.57%
Colorado,2020,General,BOULDER,2181307863,795,57,852,744,87.32%
Colorado,2020,General,BOULDER,2181307864,645,38,683,597,87.41%
Colorado,2020,General,BOULDER,2181307865,662,122,784,599,76.40%
Colorado,2020,General,BOULDER,2181307866,856,108,964,765,79.36%
Colorado,2020,General,BOULDER,2181307867,799,133,932,729,78.22%
Colorado,2020,General,BOULDER,2181307868,893,41,934,852,91.22%
Colorado,2020,General,BOULDER,2181307869,587,62,649,556,85.67%
Colorado,2020,General,BOULDER,2181307870,727,80,807,608,75.34%
Colorado,2020,General,BOULDER,2181307871,771,126,897,693,77.26%
Colorado,2020,General,BOULDER,2181307872,701,301,1002,563,56.19%
Colorado,2020,General,BOULDER,2181307873,463,45,508,431,84.84%
Colorado,2020,General,BOULDER,2181307874,1014,124,1138,904,79.44%
Colorado,2020,General,BOULDER,2181307875,470,173,643,321,49.92%
Colorado,2020,General,BOULDER,2181307876,586,352,938,419,44.67%
Colorado,2020,General,BOULDER,2181307877,662,109,771,602,78.08%
Colorado,2020,General,BOULDER,2181307878,681,185,866,569,65.70%
Colorado,2020,General,BOULDER,2181307879,638,227,865,545,63.01%
Colorado,2020,General,BOULDER,2181307880,879,416,1295,644,49.73%
Colorado,2020,General,BOULDER,2181307881,667,109,776,603,77.71%
Colorado,2020,General,BOULDER,2181307882,702,58,760,644,84.74%
Colorado,2020,General,BOULDER,2181307883,848,94,942,789,83.76%
Colorado,2020,General,BOULDER,2181307884,857,182,1039,767,73.82%
Colorado,2020,General,BOULDER,2181307885,634,56,690,604,87.54%
Colorado,2020,General,BOULDER,2181307886,831,67,898,762,84.86%
Colorado,2020,General,BOULDER,2181307887,1029,58,1087,960,88.32%
Colorado,2020,General,BOULDER,2181307888,873,41,914,824,90.15%
Colorado,2020,General,BOULDER,2181307903,732,47,779,671,86.14%
Colorado,2020,General,BOULDER,2181307904,530,44,574,490,85.37%
Colorado,2020,General,BOULDER,2181307905,292,17,309,265,85.76%
Colorado,2020,General,BOULDER,2181307906,578,25,603,536,88.89%
Colorado,2020,General,BOULDER,2181307908,1006,80,1086,924,85.08%
Colorado,2020,General,BOULDER,2181307909,577,42,619,536,86.59%
Colorado,2020,General,BOULDER,2181307910,826,62,888,748,84.23%
Colorado,2020,General,BOULDER,2181307911,935,73,1008,886,87.90%
Colorado,2020,General,BOULDER,2181307914,638,36,674,578,85.76%
Colorado,2020,General,BOULDER,2181307915,431,40,471,374,79.41%
Colorado,2020,General,BOULDER,2181307919,1201,150,1351,1080,79.94%
Colorado,2020,General,BOULDER,4171107616,1166,72,1238,1081,87.32%
Colorado,2020,General,BOULDER,4171107617,1898,199,2097,1686,80.40%
Colorado,2020,General,BOULDER,4171107618,1521,87,1608,1404,87.31%
Colorado,2020,General,BOULDER,4171107619,1770,276,2046,1484,72.53%
Colorado,2020,General,BOULDER,4171107620,1745,160,1905,1599,83.94%
Colorado,2020,General,BOULDER,4171107621,1129,90,1219,1023,83.92%
Colorado,2020,General,BOULDER,4171107622,786,96,882,659,74.72%
Colorado,2020,General,BOULDER,4171107623,1413,175,1588,1171,73.74%
Colorado,2020,General,BOULDER,4171107624,926,90,1016,849,83.56%
Colorado,2020,General,BOULDER,4171107625,891,62,953,822,86.25%
Colorado,2020,General,BOULDER,4171107626,1177,96,1273,1057,83.03%
Colorado,2020,General,BOULDER,4171107627,893,117,1010,723,71.58%
Colorado,2020,General,BOULDER,4171107628,1020,73,1093,937,85.73%
Colorado,2020,General,BOULDER,4171107629,645,65,710,570,80.28%
Colorado,2020,General,BOULDER,4171107630,1006,103,1109,832,75.02%
Colorado,2020,General,BOULDER,4171107631,722,59,781,609,77.98%
Colorado,2020,General,BOULDER,4171107632,1278,90,1368,1139,83.26%
Colorado,2020,General,BOULDER,4171107633,1091,156,1247,806,64.64%
Colorado,2020,General,BOULDER,4171107634,885,100,985,740,75.13%
Colorado,2020,General,BOULDER,4171107635,857,62,919,777,84.55%
Colorado,2020,General,BOULDER,4171107636,1194,72,1266,1085,85.70%
Colorado,2020,General,BOULDER,4171107637,1442,138,1580,1262,79.87%
Colorado,2020,General,BOULDER,4171107638,984,55,1039,917,88.26%
Colorado,2020,General,BOULDER,4171107639,971,72,1043,892,85.52%
Colorado,2020,General,BOULDER,4171107640,911,65,976,821,84.12%
Colorado,2020,General,BOULDER,4171107641,882,80,962,767,79.73%
Colorado,2020,General,BOULDER,4171107642,1344,100,1444,1202,83.24%
Colorado,2020,General,BOULDER,4171107643,908,68,976,754,77.25%
Colorado,2020,General,BOULDER,4171107644,967,141,1108,775,69.95%
Colorado,2020,General,BOULDER,4171107645,929,57,986,810,82.15%
Colorado,2020,General,BOULDER,4171107646,991,61,1052,919,87.36%
Colorado,2020,General,BOULDER,4171107647,1720,96,1816,1591,87.61%
Colorado,2020,General,BOULDER,4171107648,1274,136,1410,986,69.93%
Colorado,2020,General,BOULDER,4171107649,864,123,987,694,70.31%
Colorado,2020,General,BOULDER,4171107650,880,76,956,769,80.44%
Colorado,2020,General,BOULDER,4171107651,1078,89,1167,934,80.03%
Colorado,2020,General,BOULDER,4171107652,1075,152,1227,905,73.76%
Colorado,2020,General,BOULDER,4171107653,751,27,778,695,89.33%
Colorado,2020,General,BOULDER,4171107654,1421,197,1618,1236,76.39%
Colorado,2020,General,BOULDER,4171107655,1266,35,1301,1196,91.93%
Colorado,2020,General,BOULDER,4171207600,1455,115,1570,1314,83.69%
Colorado,2020,General,BOULDER,4171207601,1263,71,1334,1145,85.83%
Colorado,2020,General,BOULDER,4171207602,873,60,933,803,86.07%
Colorado,2020,General,BOULDER,4171207603,1446,129,1575,1307,82.98%
Colorado,2020,General,BOULDER,4171207604,1029,60,1089,900,82.64%
Colorado,2020,General,BOULDER,4171207605,1151,71,1222,1014,82.98%
Colorado,2020,General,BOULDER,4171207606,1041,71,1112,881,79.23%
Colorado,2020,General,BOULDER,4171207607,1100,72,1172,964,82.25%
Colorado,2020,General,BOULDER,4171207608,1046,100,1146,843,73.56%
Colorado,2020,General,BOULDER,4171207609,612,66,678,478,70.50%
Colorado,2020,General,BOULDER,4171207610,1451,135,1586,1280,80.71%
Colorado,2020,General,BOULDER,4171207611,1217,100,1317,1039,78.89%
Colorado,2020,General,BOULDER,4171207612,1147,73,1220,1025,84.02%
Colorado,2020,General,BOULDER,4171207613,891,77,968,778,80.37%
Colorado,2020,General,BOULDER,4171207614,1494,100,1594,1401,87.89%
Colorado,2020,General,BOULDER,4171207615,874,47,921,801,86.97%
Colorado,2020,General,BOULDER,4171207656,1124,86,1210,909,75.12%
Colorado,2020,General,BOULDER,4171207657,1278,40,1318,1183,89.76%
Colorado,2020,General,BOULDER,4181107706,202,12,214,183,85.51%
Colorado,2020,General,BOULDER,4181107707,669,26,695,620,89.21%
Colorado,2020,General,BOULDER,4181107708,701,48,749,624,83.31%
Colorado,2020,General,BROOMFIELD,2233364001,1679,186,1865,1562,83.75%
Colorado,2020,General,BROOMFIELD,2233364002,2355,610,2965,2089,70.46%
Colorado,2020,General,BROOMFIELD,2233364003,1847,393,2240,1623,72.46%
Colorado,2020,General,BROOMFIELD,2233364004,1753,201,1954,1544,79.02%
Colorado,2020,General,BROOMFIELD,2233364005,99,34,133,75,56.39%
Colorado,2020,General,BROOMFIELD,2233364006,2309,500,2809,2009,71.52%
Colorado,2020,General,BROOMFIELD,2233364007,929,164,1093,798,73.01%
Colorado,2020,General,BROOMFIELD,2233364008,697,121,818,619,75.67%
Colorado,2020,General,BROOMFIELD,2233364009,870,79,949,789,83.14%
Colorado,2020,General,BROOMFIELD,2233364010,1173,64,1237,1078,87.15%
Colorado,2020,General,BROOMFIELD,2233364011,1176,103,1279,1063,83.11%
Colorado,2020,General,BROOMFIELD,2233364012,1208,58,1266,1137,89.81%
Colorado,2020,General,BROOMFIELD,2233364013,962,97,1059,872,82.34%
Colorado,2020,General,BROOMFIELD,2233364014,1067,94,1161,954,82.17%
Colorado,2020,General,BROOMFIELD,2233364015,1198,89,1287,1083,84.15%
Colorado,2020,General,BROOMFIELD,2233364016,1153,56,1209,1079,89.25%
Colorado,2020,General,BROOMFIELD,2233364017,1600,67,1667,1492,89.50%
Colorado,2020,General,BROOMFIELD,2233364018,884,126,1010,796,78.81%
Colorado,2020,General,BROOMFIELD,2233364019,1363,230,1593,1181,74.14%
Colorado,2020,General,BROOMFIELD,2233364020,965,77,1042,875,83.97%
Colorado,2020,General,BROOMFIELD,2233364021,1949,187,2136,1690,79.12%
Colorado,2020,General,BROOMFIELD,2233364022,1376,96,1472,1267,86.07%
Colorado,2020,General,BROOMFIELD,2233364023,1138,56,1194,1042,87.27%
Colorado,2020,General,BROOMFIELD,2233364024,2113,138,2251,1961,87.12%
Colorado,2020,General,BROOMFIELD,2233364025,2022,158,2180,1858,85.23%
Colorado,2020,General,BROOMFIELD,2233364026,1209,73,1282,1146,89.39%
Colorado,2020,General,BROOMFIELD,2233364027,1563,208,1771,1413,79.79%
Colorado,2020,General,BROOMFIELD,2233364028,636,94,730,450,61.64%
Colorado,2020,General,BROOMFIELD,2233364029,1301,83,1384,1178,85.12%
Colorado,2020,General,BROOMFIELD,2233364030,1177,109,1286,1020,79.32%
Colorado,2020,General,BROOMFIELD,2233364031,1080,84,1164,951,81.70%
Colorado,2020,General,BROOMFIELD,2233364032,2249,150,2399,2123,88.50%
Colorado,2020,General,BROOMFIELD,2233364033,1712,121,1833,1613,88.00%
Colorado,2020,General,BROOMFIELD,2233364034,649,31,680,617,90.74%
Colorado,2020,General,BROOMFIELD,2233364035,2220,77,2297,2146,93.43%
Colorado,2020,General,BROOMFIELD,2233364036,2934,137,3071,2754,89.68%
Colorado,2020,General,BROOMFIELD,2233364037,1253,81,1334,1156,86.66%
Colorado,2020,General,CHAFFEE,5056008001,1505,164,1669,1364,81.73%
Colorado,2020,General,CHAFFEE,5056008002,1967,239,2206,1789,81.10%
Colorado,2020,General,CHAFFEE,5056008003,2341,319,2660,2118,79.62%
Colorado,2020,General,CHAFFEE,5056008004,1124,126,1250,1038,83.04%
Colorado,2020,General,CHAFFEE,5056008005,1898,189,2087,1718,82.32%
Colorado,2020,General,CHAFFEE,5056008006,1979,195,2174,1807,83.12%
Colorado,2020,General,CHAFFEE,5056008007,1561,186,1747,1420,81.28%
Colorado,2020,General,CHAFFEE,5056008008,1497,188,1685,1364,80.95%
Colorado,2020,General,CHAFFEE,5056008009,1387,187,1574,1244,79.03%
Colorado,2020,General,CHEYENNE,4016509001,133,18,151,120,79.47%
Colorado,2020,General,CHEYENNE,4016509002,358,58,416,326,78.37%
Colorado,2020,General,CHEYENNE,4016509003,422,41,463,378,81.64%
Colorado,2020,General,CHEYENNE,4016509004,301,26,327,259,79.20%
Colorado,2020,General,CHEYENNE,4016509005,68,3,71,63,88.73%
Colorado,2020,General,CLEAR CREEK,2021310001,1066,161,1227,929,75.71%
Colorado,2020,General,CLEAR CREEK,2021310002,398,73,471,329,69.85%
Colorado,2020,General,CLEAR CREEK,2021310003,481,64,545,401,73.58%
Colorado,2020,General,CLEAR CREEK,2021310004,988,157,1145,828,72.31%
Colorado,2020,General,CLEAR CREEK,2021310005,845,113,958,727,75.89%
Colorado,2020,General,CLEAR CREEK,2021310006,571,110,681,451,66.23%
Colorado,2020,General,CLEAR CREEK,2021310007,1305,152,1457,1180,80.99%
Colorado,2020,General,CLEAR CREEK,2021310008,784,65,849,709,83.51%
Colorado,2020,General,CLEAR CREEK,2021310009,1159,102,1261,1057,83.82%
Colorado,2020,General,CONEJOS,3356211001,454,31,485,381,78.56%
Colorado,2020,General,CONEJOS,3356211002,544,42,586,454,77.47%
Colorado,2020,General,CONEJOS,3356211003,429,41,470,375,79.79%
Colorado,2020,General,CONEJOS,3356211004,484,29,513,413,80.51%
Colorado,2020,General,CONEJOS,3356211005,545,57,602,449,74.58%
Colorado,2020,General,CONEJOS,3356211006,697,51,748,614,82.09%
Colorado,2020,General,CONEJOS,3356211007,357,29,386,303,78.50%
Colorado,2020,General,CONEJOS,3356211008,786,51,837,656,78.38%
Colorado,2020,General,CONEJOS,3356211009,428,29,457,386,84.46%
Colorado,2020,General,CONEJOS,3356211010,451,35,486,373,76.75%
Colorado,2020,General,COSTILLA,3356212001,227,18,245,201,82.04%
Colorado,2020,General,COSTILLA,3356212002,246,11,257,219,85.21%
Colorado,2020,General,COSTILLA,3356212003,182,15,197,156,79.19%
Colorado,2020,General,COSTILLA,3356212004,341,33,374,246,65.78%
Colorado,2020,General,COSTILLA,3356212005,232,33,265,177,66.79%
Colorado,2020,General,COSTILLA,3356212006,130,9,139,101,72.66%
Colorado,2020,General,COSTILLA,3356212007,790,141,931,632,67.88%
Colorado,2020,General,COSTILLA,3356212008,531,87,618,407,65.86%
Colorado,2020,General,CROWLEY,4356413001,439,48,487,381,78.23%
Colorado,2020,General,CROWLEY,4356413002,345,40,385,298,77.40%
Colorado,2020,General,CROWLEY,4356413003,327,39,366,254,69.40%
Colorado,2020,General,CROWLEY,4356413004,324,29,353,278,78.75%
Colorado,2020,General,CROWLEY,4356413005,362,23,385,287,74.55%
Colorado,2020,General,CROWLEY,4356413006,332,53,385,271,70.39%
Colorado,2020,General,CUSTER,3356014001,2087,252,2339,1876,80.21%
Colorado,2020,General,CUSTER,3356014002,458,33,491,418,85.13%
Colorado,2020,General,CUSTER,3356014003,1517,122,1639,1380,84.20%
Colorado,2020,General,DELTA,3055415001,1241,45,1286,1140,88.65%
Colorado,2020,General,DELTA,3055415002,816,85,901,687,76.25%
Colorado,2020,General,DELTA,3055415003,815,101,916,651,71.07%
Colorado,2020,General,DELTA,3055415004,1244,169,1413,1017,71.97%
Colorado,2020,General,DELTA,3055415005,864,78,942,737,78.24%
Colorado,2020,General,DELTA,3055415006,1121,110,1231,970,78.80%
Colorado,2020,General,DELTA,3055415007,1160,65,1225,1026,83.76%
Colorado,2020,General,DELTA,3056115008,1363,92,1455,1167,80.21%
Colorado,2020,General,DELTA,3056115009,1350,83,1433,1190,83.04%
Colorado,2020,General,DELTA,3056115010,1127,85,1212,1009,83.25%
Colorado,2020,General,DELTA,3056115011,1094,92,1186,992,83.64%
Colorado,2020,General,DELTA,3056115012,889,59,948,779,82.17%
Colorado,2020,General,DELTA,3056115013,1016,74,1090,926,84.95%
Colorado,2020,General,DELTA,3056115014,1213,69,1282,1114,86.90%
Colorado,2020,General,DELTA,3056115015,1393,79,1472,1262,85.73%
Colorado,2020,General,DELTA,3056115016,1132,73,1205,1016,84.32%
Colorado,2020,General,DELTA,3056115017,1054,97,1151,936,81.32%
Colorado,2020,General,DELTA,3056115018,1226,74,1300,1105,85.00%
Colorado,2020,General,DELTA,3056115019,882,74,956,783,81.90%
Colorado,2020,General,DELTA,3056115020,1156,101,1257,1046,83.21%
Colorado,2020,General,DENVER,1160116112,1216,93,1309,1061,81.05%
Colorado,2020,General,DENVER,1160116113,1095,36,1131,945,83.55%
Colorado,2020,General,DENVER,1160116114,1306,108,1414,1138,80.48%
Colorado,2020,General,DENVER,1160116120,1630,309,1939,1311,67.61%
Colorado,2020,General,DENVER,1160116122,1307,70,1377,1156,83.95%
Colorado,2020,General,DENVER,1160116123,1346,118,1464,1186,81.01%
Colorado,2020,General,DENVER,1160116124,1276,74,1350,1106,81.93%
Colorado,2020,General,DENVER,1160116125,1383,142,1525,1214,79.61%
Colorado,2020,General,DENVER,1160116126,1587,252,1839,1374,74.71%
Colorado,2020,General,DENVER,1160116127,1703,244,1947,1502,77.14%
Colorado,2020,General,DENVER,1160116128,1024,53,1077,923,85.70%
Colorado,2020,General,DENVER,1160116129,871,45,916,790,86.24%
Colorado,2020,General,DENVER,1160116130,1260,93,1353,1053,77.83%
Colorado,2020,General,DENVER,1160116131,1303,84,1387,1126,81.18%
Colorado,2020,General,DENVER,1160116132,1401,125,1526,1252,82.04%
Colorado,2020,General,DENVER,1310216204,1693,396,2089,1418,67.88%
Colorado,2020,General,DENVER,1310216205,1493,290,1783,1266,71.00%
Colorado,2020,General,DENVER,1310216206,1773,493,2266,1563,68.98%
Colorado,2020,General,DENVER,1310216207,1405,250,1655,1232,74.44%
Colorado,2020,General,DENVER,1310216208,1403,320,1723,1196,69.41%
Colorado,2020,General,DENVER,1310216209,1216,205,1421,1095,77.06%
Colorado,2020,General,DENVER,1310216210,1320,208,1528,1189,77.81%
Colorado,2020,General,DENVER,1310216211,1112,211,1323,1009,76.27%
Colorado,2020,General,DENVER,1310516530,129,30,159,95,59.75%
Colorado,2020,General,DENVER,1310616605,891,67,958,844,88.10%
Colorado,2020,General,DENVER,1310616606,1010,99,1109,959,86.47%
Colorado,2020,General,DENVER,1310616607,760,62,822,715,86.98%
Colorado,2020,General,DENVER,1310616609,325,17,342,307,89.77%
Colorado,2020,General,DENVER,1310616610,385,25,410,371,90.49%
Colorado,2020,General,DENVER,1310616611,817,89,906,754,83.22%
Colorado,2020,General,DENVER,1310616612,1200,112,1312,1097,83.61%
Colorado,2020,General,DENVER,1310616613,1216,111,1327,1120,84.40%
Colorado,2020,General,DENVER,1310616614,755,51,806,703,87.22%
Colorado,2020,General,DENVER,1310616615,997,54,1051,943,89.72%
Colorado,2020,General,DENVER,1310616617,1068,102,1170,982,83.93%
Colorado,2020,General,DENVER,1310616618,971,76,1047,895,85.48%
Colorado,2020,General,DENVER,1310616619,1271,104,1375,1167,84.87%
Colorado,2020,General,DENVER,1310616622,1217,63,1280,1140,89.06%
Colorado,2020,General,DENVER,1310616623,1306,66,1372,1239,90.31%
Colorado,2020,General,DENVER,1310616624,1316,67,1383,1237,89.44%
Colorado,2020,General,DENVER,1310616625,918,54,972,815,83.85%
Colorado,2020,General,DENVER,1310616626,995,90,1085,897,82.67%
Colorado,2020,General,DENVER,1310616627,1192,48,1240,1113,89.76%
Colorado,2020,General,DENVER,1310616628,1556,197,1753,1356,77.35%
Colorado,2020,General,DENVER,1310616629,1427,48,1475,1322,89.63%
Colorado,2020,General,DENVER,1310616630,835,46,881,776,88.08%
Colorado,2020,General,DENVER,1310616631,1928,378,2306,1643,71.25%
Colorado,2020,General,DENVER,1310616641,1502,156,1658,1341,80.88%
Colorado,2020,General,DENVER,1310616642,1131,63,1194,1018,85.26%
Colorado,2020,General,DENVER,1310616643,917,127,1044,782,74.90%
Colorado,2020,General,DENVER,1310616644,1106,87,1193,1026,86.00%
Colorado,2020,General,DENVER,1310616645,1050,77,1127,970,86.07%
Colorado,2020,General,DENVER,1310616646,1609,321,1930,1261,65.34%
Colorado,2020,General,DENVER,1310616647,1311,117,1428,1140,79.83%
Colorado,2020,General,DENVER,1310616648,1328,103,1431,1192,83.30%
Colorado,2020,General,DENVER,1310616649,2032,479,2511,1527,60.81%
Colorado,2020,General,DENVER,1310616650,1148,177,1325,1005,75.85%
Colorado,2020,General,DENVER,1310616651,1541,373,1914,1295,67.66%
Colorado,2020,General,DENVER,1310616652,1082,50,1132,1022,90.28%
Colorado,2020,General,DENVER,1310816841,1275,257,1532,1127,73.56%
Colorado,2020,General,DENVER,1310816842,1009,154,1163,889,76.44%
Colorado,2020,General,DENVER,1310816843,1171,209,1380,1064,77.10%
Colorado,2020,General,DENVER,1310816844,1390,262,1652,1214,73.49%
Colorado,2020,General,DENVER,1310816845,1173,187,1360,1050,77.21%
Colorado,2020,General,DENVER,1310816846,1153,180,1333,1028,77.12%
Colorado,2020,General,DENVER,1310816848,1274,230,1504,1154,76.73%
Colorado,2020,General,DENVER,1310816849,1345,201,1546,1235,79.88%
Colorado,2020,General,DENVER,1310816850,1116,113,1229,1046,85.11%
Colorado,2020,General,DENVER,1310816851,1340,139,1479,1227,82.96%
Colorado,2020,General,DENVER,1310816852,986,69,1055,938,88.91%
Colorado,2020,General,DENVER,1310816853,983,30,1013,926,91.41%
Colorado,2020,General,DENVER,1310816854,1115,144,1259,1039,82.53%
Colorado,2020,General,DENVER,1310816855,769,140,909,631,69.42%
Colorado,2020,General,DENVER,1310816856,1940,376,2316,1712,73.92%
Colorado,2020,General,DENVER,1310916901,1673,352,2025,1413,69.78%
Colorado,2020,General,DENVER,1310916903,1351,105,1456,1255,86.20%
Colorado,2020,General,DENVER,1310916904,1258,93,1351,1174,86.90%
Colorado,2020,General,DENVER,1310916905,318,19,337,294,87.24%
Colorado,2020,General,DENVER,1310916906,1215,55,1270,1126,88.66%
Colorado,2020,General,DENVER,1310916908,1340,137,1477,1216,82.33%
Colorado,2020,General,DENVER,1310916909,1347,85,1432,1231,85.96%
Colorado,2020,General,DENVER,1310916910,1665,171,1836,1477,80.45%
Colorado,2020,General,DENVER,1310916911,1862,413,2275,1463,64.31%
Colorado,2020,General,DENVER,1310916912,1414,260,1674,1173,70.07%
Colorado,2020,General,DENVER,1310916916,1864,245,2109,1676,79.47%
Colorado,2020,General,DENVER,1310916917,1519,121,1640,1377,83.96%
Colorado,2020,General,DENVER,1310916918,1366,75,1441,1263,87.65%
Colorado,2020,General,DENVER,1310916919,1337,54,1391,1271,91.37%
Colorado,2020,General,DENVER,1310916920,1328,93,1421,1202,84.59%
Colorado,2020,General,DENVER,1310916921,1846,446,2292,1414,61.69%
Colorado,2020,General,DENVER,1310916922,1849,380,2229,1521,68.24%
Colorado,2020,General,DENVER,1310916923,1549,266,1815,1279,70.47%
Colorado,2020,General,DENVER,1310916924,1479,522,2001,1027,51.32%
Colorado,2020,General,DENVER,1310916927,1140,81,1221,1041,85.26%
Colorado,2020,General,DENVER,1310916928,881,41,922,831,90.13%
Colorado,2020,General,DENVER,1310916929,1046,137,1183,909,76.84%
Colorado,2020,General,DENVER,1310916930,1078,93,1171,891,76.09%
Colorado,2020,General,DENVER,1310916931,828,20,848,788,92.92%
Colorado,2020,General,DENVER,1310916932,1224,137,1361,1057,77.66%
Colorado,2020,General,DENVER,1310916933,792,35,827,743,89.84%
Colorado,2020,General,DENVER,1310916934,1019,107,1126,891,79.13%
Colorado,2020,General,DENVER,1310916935,1702,383,2085,1465,70.26%
Colorado,2020,General,DENVER,1310916936,1213,220,1433,996,69.50%
Colorado,2020,General,DENVER,1310916937,1225,134,1359,1130,83.15%
Colorado,2020,General,DENVER,1310916938,1484,237,1721,1302,75.65%
Colorado,2020,General,DENVER,1310916940,1119,217,1336,978,73.20%
Colorado,2020,General,DENVER,1320116103,1591,121,1712,1218,71.14%
Colorado,2020,General,DENVER,1320116104,1277,156,1433,936,65.32%
Colorado,2020,General,DENVER,1320116105,1654,104,1758,1328,75.54%
Colorado,2020,General,DENVER,1320116106,1750,117,1867,1372,73.49%
Colorado,2020,General,DENVER,1320116107,1774,155,1929,1427,73.98%
Colorado,2020,General,DENVER,1320116108,1813,131,1944,1467,75.46%
Colorado,2020,General,DENVER,1320116109,1194,112,1306,824,63.09%
Colorado,2020,General,DENVER,1320116110,1462,75,1537,1281,83.34%
Colorado,2020,General,DENVER,1320116111,1734,141,1875,1499,79.95%
Colorado,2020,General,DENVER,1320116115,454,35,489,407,83.23%
Colorado,2020,General,DENVER,1320116116,1276,48,1324,1101,83.16%
Colorado,2020,General,DENVER,1320116117,1208,73,1281,1057,82.51%
Colorado,2020,General,DENVER,1320116118,1436,256,1692,1066,63.00%
Colorado,2020,General,DENVER,1320116119,1574,206,1780,1135,63.76%
Colorado,2020,General,DENVER,1320116121,1315,64,1379,1120,81.22%
Colorado,2020,General,DENVER,1320216212,1482,196,1678,1302,77.59%
Colorado,2020,General,DENVER,1320216213,1110,106,1216,946,77.80%
Colorado,2020,General,DENVER,1320216214,1162,189,1351,1023,75.72%
Colorado,2020,General,DENVER,1320216215,1643,236,1879,1488,79.19%
Colorado,2020,General,DENVER,1320216216,1505,217,1722,1380,80.14%
Colorado,2020,General,DENVER,1320216217,1259,163,1422,1159,81.50%
Colorado,2020,General,DENVER,1320216218,1010,160,1170,902,77.09%
Colorado,2020,General,DENVER,1320216219,2351,334,2685,2125,79.14%
Colorado,2020,General,DENVER,1320216220,2079,267,2346,1886,80.39%
Colorado,2020,General,DENVER,1320216221,1839,235,2074,1646,79.36%
Colorado,2020,General,DENVER,1320216222,1062,101,1163,967,83.15%
Colorado,2020,General,DENVER,1320216223,905,91,996,827,83.03%
Colorado,2020,General,DENVER,1320216224,1761,184,1945,1601,82.31%
Colorado,2020,General,DENVER,1320216225,890,84,974,830,85.22%
Colorado,2020,General,DENVER,1320216226,929,75,1004,865,86.16%
Colorado,2020,General,DENVER,1320216227,975,83,1058,914,86.39%
Colorado,2020,General,DENVER,1320216228,643,27,670,613,91.49%
Colorado,2020,General,DENVER,1320216229,860,53,913,813,89.05%
Colorado,2020,General,DENVER,1320216230,889,60,949,853,89.88%
Colorado,2020,General,DENVER,1320216231,982,80,1062,916,86.25%
Colorado,2020,General,DENVER,1320216232,1294,173,1467,1075,73.28%
Colorado,2020,General,DENVER,1320216233,2122,207,2329,1971,84.63%
Colorado,2020,General,DENVER,1320216234,1803,158,1961,1714,87.40%
Colorado,2020,General,DENVER,1320216235,1458,125,1583,1381,87.24%
Colorado,2020,General,DENVER,1320216236,1212,136,1348,1099,81.53%
Colorado,2020,General,DENVER,1320216237,1138,779,1917,920,47.99%
Colorado,2020,General,DENVER,1320216238,1999,396,2395,1742,72.73%
Colorado,2020,General,DENVER,1320216239,1319,135,1454,1180,81.16%
Colorado,2020,General,DENVER,1320216240,1159,158,1317,956,72.59%
Colorado,2020,General,DENVER,1320216241,1080,103,1183,987,83.43%
Colorado,2020,General,DENVER,1320216242,1044,105,1149,927,80.68%
Colorado,2020,General,DENVER,1320216243,1316,145,1461,1160,79.40%
Colorado,2020,General,DENVER,1320216244,1285,225,1510,1117,73.97%
Colorado,2020,General,DENVER,1320216245,1343,106,1449,1214,83.78%
Colorado,2020,General,DENVER,1320216246,1221,102,1323,1126,85.11%
Colorado,2020,General,DENVER,1320216247,1011,91,1102,924,83.85%
Colorado,2020,General,DENVER,1320216248,1011,59,1070,949,88.69%
Colorado,2020,General,DENVER,1320216249,1343,58,1401,1294,92.36%
Colorado,2020,General,DENVER,1320216250,1296,62,1358,1215,89.47%
Colorado,2020,General,DENVER,1320216251,1139,158,1297,1038,80.03%
Colorado,2020,General,DENVER,1320516532,708,88,796,616,77.39%
Colorado,2020,General,DENVER,1320516533,1502,151,1653,1187,71.81%
Colorado,2020,General,DENVER,1320516534,1478,122,1600,1170,73.13%
Colorado,2020,General,DENVER,1320516535,1624,125,1749,1305,74.61%
Colorado,2020,General,DENVER,1320516536,1286,96,1382,1020,73.81%
Colorado,2020,General,DENVER,1320516537,1539,140,1679,1117,66.53%
Colorado,2020,General,DENVER,1320516538,1236,104,1340,955,71.27%
Colorado,2020,General,DENVER,1320516539,1161,86,1247,872,69.93%
Colorado,2020,General,DENVER,1320616608,1351,83,1434,1260,87.87%
Colorado,2020,General,DENVER,1320616616,1298,62,1360,1204,88.53%
Colorado,2020,General,DENVER,1320616620,1436,259,1695,1266,74.69%
Colorado,2020,General,DENVER,1320616621,1239,170,1409,1135,80.55%
Colorado,2020,General,DENVER,1320616632,1096,115,1211,1041,85.96%
Colorado,2020,General,DENVER,1320616633,1160,77,1237,1107,89.49%
Colorado,2020,General,DENVER,1320616634,908,50,958,838,87.47%
Colorado,2020,General,DENVER,1320616635,1548,137,1685,1412,83.80%
Colorado,2020,General,DENVER,1320616636,1188,80,1268,1122,88.49%
Colorado,2020,General,DENVER,1320616637,1208,67,1275,1157,90.75%
Colorado,2020,General,DENVER,1320616638,699,37,736,671,91.17%
Colorado,2020,General,DENVER,1320616639,1128,75,1203,1067,88.69%
Colorado,2020,General,DENVER,1320616640,1478,92,1570,1391,88.60%
Colorado,2020,General,DENVER,1320916902,1355,453,1808,1080,59.73%
Colorado,2020,General,DENVER,1320916907,1590,225,1815,1301,71.68%
Colorado,2020,General,DENVER,1320916913,1627,139,1766,1469,83.18%
Colorado,2020,General,DENVER,1320916914,1107,80,1187,1028,86.60%
Colorado,2020,General,DENVER,1320916915,1162,105,1267,1041,82.16%
Colorado,2020,General,DENVER,1320916925,774,38,812,715,88.05%
Colorado,2020,General,DENVER,1320916926,797,63,860,721,83.84%
Colorado,2020,General,DENVER,1320916939,844,136,980,735,75.00%
Colorado,2020,General,DENVER,1330516516,821,93,914,677,74.07%
Colorado,2020,General,DENVER,1330516520,1578,2960,4538,956,21.07%
Colorado,2020,General,DENVER,1330516521,1229,156,1385,997,71.99%
Colorado,2020,General,DENVER,1330616601,639,50,689,579,84.03%
Colorado,2020,General,DENVER,1330616602,1005,157,1162,866,74.53%
Colorado,2020,General,DENVER,1330616603,1066,123,1189,910,76.53%
Colorado,2020,General,DENVER,1330616604,1686,454,2140,1271,59.39%
Colorado,2020,General,DENVER,1330716701,1253,169,1422,1009,70.96%
Colorado,2020,General,DENVER,1330716702,1400,143,1543,1312,85.03%
Colorado,2020,General,DENVER,1330716703,732,51,783,674,86.08%
Colorado,2020,General,DENVER,1330716704,900,97,997,724,72.62%
Colorado,2020,General,DENVER,1330716705,1721,175,1896,1581,83.39%
Colorado,2020,General,DENVER,1330716706,1118,61,1179,1056,89.57%
Colorado,2020,General,DENVER,1330716707,886,73,959,857,89.36%
Colorado,2020,General,DENVER,1330716708,1585,162,1747,1488,85.17%
Colorado,2020,General,DENVER,1330716709,805,66,871,726,83.35%
Colorado,2020,General,DENVER,1330716710,949,84,1033,880,85.19%
Colorado,2020,General,DENVER,1330716711,463,53,516,407,78.88%
Colorado,2020,General,DENVER,1330716712,308,29,337,264,78.34%
Colorado,2020,General,DENVER,1330716713,1163,95,1258,1082,86.01%
Colorado,2020,General,DENVER,1330716714,1244,212,1456,893,61.33%
Colorado,2020,General,DENVER,1330716715,1231,99,1330,833,62.63%
Colorado,2020,General,DENVER,1330716716,1039,111,1150,715,62.17%
Colorado,2020,General,DENVER,1330716717,1197,113,1310,834,63.66%
Colorado,2020,General,DENVER,1330716718,1208,130,1338,810,60.54%
Colorado,2020,General,DENVER,1330716719,1076,101,1177,819,69.58%
Colorado,2020,General,DENVER,1330716720,1047,257,1304,721,55.29%
Colorado,2020,General,DENVER,1330716721,950,75,1025,736,71.80%
Colorado,2020,General,DENVER,1330716722,1226,94,1320,902,68.33%
Colorado,2020,General,DENVER,1330716723,1147,69,1216,845,69.49%
Colorado,2020,General,DENVER,1330716724,1081,103,1184,813,68.67%
Colorado,2020,General,DENVER,1330716725,1179,98,1277,853,66.80%
Colorado,2020,General,DENVER,1330716726,1206,118,1324,907,68.50%
Colorado,2020,General,DENVER,1330716727,1283,115,1398,1028,73.53%
Colorado,2020,General,DENVER,1330716728,2416,282,2698,1878,69.61%
Colorado,2020,General,DENVER,1330716729,2547,276,2823,2097,74.28%
Colorado,2020,General,DENVER,1330716730,2038,137,2175,1772,81.47%
Colorado,2020,General,DENVER,1330716731,1677,174,1851,1403,75.80%
Colorado,2020,General,DENVER,1330716732,1011,86,1097,816,74.38%
Colorado,2020,General,DENVER,1330716733,2774,350,3124,2286,73.18%
Colorado,2020,General,DENVER,1330716734,1288,242,1530,976,63.79%
Colorado,2020,General,DENVER,1330716735,1060,123,1183,834,70.50%
Colorado,2020,General,DENVER,1330716736,954,97,1051,743,70.69%
Colorado,2020,General,DENVER,1330716737,1093,122,1215,820,67.49%
Colorado,2020,General,DENVER,1330716738,1126,88,1214,900,74.14%
Colorado,2020,General,DENVER,1330716739,1172,110,1282,927,72.31%
Colorado,2020,General,DENVER,1330716740,1105,98,1203,850,70.66%
Colorado,2020,General,DENVER,1330716741,1140,138,1278,881,68.94%
Colorado,2020,General,DENVER,1330716742,1245,159,1404,981,69.87%
Colorado,2020,General,DENVER,1330716743,929,47,976,896,91.80%
Colorado,2020,General,DENVER,1330716744,2012,213,2225,1840,82.70%
Colorado,2020,General,DENVER,1330716745,1800,102,1902,1706,89.70%
Colorado,2020,General,DENVER,1330716746,2309,41,2350,2206,93.87%
Colorado,2020,General,DENVER,1330816801,1097,156,1253,903,72.07%
Colorado,2020,General,DENVER,1330816802,1024,105,1129,845,74.84%
Colorado,2020,General,DENVER,1330816803,1112,97,1209,834,68.98%
Colorado,2020,General,DENVER,1330816804,927,109,1036,760,73.36%
Colorado,2020,General,DENVER,1330816805,964,114,1078,769,71.34%
Colorado,2020,General,DENVER,1330816806,1288,215,1503,1075,71.52%
Colorado,2020,General,DENVER,1330816807,1705,201,1906,1322,69.36%
Colorado,2020,General,DENVER,1330816808,1632,230,1862,1273,68.37%
Colorado,2020,General,DENVER,1330816810,1753,266,2019,1453,71.97%
Colorado,2020,General,DENVER,1330816811,1148,172,1320,949,71.89%
Colorado,2020,General,DENVER,1330816812,1165,189,1354,981,72.45%
Colorado,2020,General,DENVER,1330816813,1162,160,1322,912,68.99%
Colorado,2020,General,DENVER,1330816814,930,90,1020,792,77.65%
Colorado,2020,General,DENVER,1330816815,902,96,998,795,79.66%
Colorado,2020,General,DENVER,1330816816,849,103,952,767,80.57%
Colorado,2020,General,DENVER,1330816817,1017,75,1092,878,80.40%
Colorado,2020,General,DENVER,1330816818,807,75,882,693,78.57%
Colorado,2020,General,DENVER,1330816819,1061,88,1149,904,78.68%
Colorado,2020,General,DENVER,1330816820,1038,89,1127,923,81.90%
Colorado,2020,General,DENVER,1330816821,982,100,1082,860,79.48%
Colorado,2020,General,DENVER,1330816822,1115,89,1204,951,78.99%
Colorado,2020,General,DENVER,1330816823,1082,62,1144,1012,88.46%
Colorado,2020,General,DENVER,1330816824,1059,68,1127,996,88.38%
Colorado,2020,General,DENVER,1330816825,1048,60,1108,961,86.73%
Colorado,2020,General,DENVER,1330816826,1302,205,1507,1096,72.73%
Colorado,2020,General,DENVER,1330816827,1388,167,1555,1247,80.19%
Colorado,2020,General,DENVER,1330816828,1817,455,2272,1473,64.83%
Colorado,2020,General,DENVER,1330816829,1634,259,1893,1523,80.45%
Colorado,2020,General,DENVER,1330816830,1183,135,1318,1060,80.42%
Colorado,2020,General,DENVER,1330816831,1020,40,1060,967,91.23%
Colorado,2020,General,DENVER,1330816832,997,48,1045,957,91.58%
Colorado,2020,General,DENVER,1330816833,1152,62,1214,1068,87.97%
Colorado,2020,General,DENVER,1330816834,1062,94,1156,980,84.78%
Colorado,2020,General,DENVER,1330816835,1104,68,1172,1032,88.05%
Colorado,2020,General,DENVER,1330816836,1256,270,1526,1053,69.00%
Colorado,2020,General,DENVER,1330816837,1200,211,1411,1043,73.92%
Colorado,2020,General,DENVER,1330816838,1264,209,1473,1004,68.16%
Colorado,2020,General,DENVER,1330816839,575,25,600,547,91.17%
Colorado,2020,General,DENVER,1330816840,597,29,626,577,92.17%
Colorado,2020,General,DENVER,1330816847,613,79,692,553,79.91%
Colorado,2020,General,DENVER,1340116101,1775,215,1990,1232,61.91%
Colorado,2020,General,DENVER,1340116102,1824,168,1992,1238,62.15%
Colorado,2020,General,DENVER,1340216201,1940,431,2371,1743,73.51%
Colorado,2020,General,DENVER,1340216202,1427,362,1789,1165,65.12%
Colorado,2020,General,DENVER,1340216203,1135,232,1367,917,67.08%
Colorado,2020,General,DENVER,1340416401,1464,113,1577,1303,82.63%
Colorado,2020,General,DENVER,1340416402,1542,337,1879,1359,72.33%
Colorado,2020,General,DENVER,1340416403,1466,116,1582,1251,79.08%
Colorado,2020,General,DENVER,1340416404,1587,144,1731,1461,84.40%
Colorado,2020,General,DENVER,1340416405,1310,112,1422,1193,83.90%
Colorado,2020,General,DENVER,1340416406,1025,89,1114,926,83.12%
Colorado,2020,General,DENVER,1340416407,1580,134,1714,1445,84.31%
Colorado,2020,General,DENVER,1340416408,1722,178,1900,1558,82.00%
Colorado,2020,General,DENVER,1340416409,1272,95,1367,1180,86.32%
Colorado,2020,General,DENVER,1340416410,1143,98,1241,1037,83.56%
Colorado,2020,General,DENVER,1340416411,1142,132,1274,1024,80.38%
Colorado,2020,General,DENVER,1340416412,1560,160,1720,1434,83.37%
Colorado,2020,General,DENVER,1340416413,1563,83,1646,1448,87.97%
Colorado,2020,General,DENVER,1340416414,1422,120,1542,1323,85.80%
Colorado,2020,General,DENVER,1340416415,2035,212,2247,1890,84.11%
Colorado,2020,General,DENVER,1340416416,1358,155,1513,1207,79.78%
Colorado,2020,General,DENVER,1340416417,1190,95,1285,1066,82.96%
Colorado,2020,General,DENVER,1340416418,1736,234,1970,1545,78.43%
Colorado,2020,General,DENVER,1340416419,1471,122,1593,1348,84.62%
Colorado,2020,General,DENVER,1340416420,1411,138,1549,1182,76.31%
Colorado,2020,General,DENVER,1340416421,1583,165,1748,1440,82.38%
Colorado,2020,General,DENVER,1340416422,1629,137,1766,1503,85.11%
Colorado,2020,General,DENVER,1340416423,1622,247,1869,1284,68.70%
Colorado,2020,General,DENVER,1340416424,1974,238,2212,1681,75.99%
Colorado,2020,General,DENVER,1340416425,1370,188,1558,1066,68.42%
Colorado,2020,General,DENVER,1340416426,2674,352,3026,2188,72.31%
Colorado,2020,General,DENVER,1340416427,413,112,525,220,41.90%
Colorado,2020,General,DENVER,1340416428,1555,261,1816,1110,61.12%
Colorado,2020,General,DENVER,1340416429,1540,155,1695,1172,69.14%
Colorado,2020,General,DENVER,1340416430,1249,117,1366,998,73.06%
Colorado,2020,General,DENVER,1340416431,1623,119,1742,1309,75.14%
Colorado,2020,General,DENVER,1340416432,1422,143,1565,1095,69.97%
Colorado,2020,General,DENVER,1340416433,1537,115,1652,1155,69.92%
Colorado,2020,General,DENVER,1340416434,1549,167,1716,1175,68.47%
Colorado,2020,General,DENVER,1340416435,1350,109,1459,943,64.63%
Colorado,2020,General,DENVER,1340416436,1448,191,1639,965,58.88%
Colorado,2020,General,DENVER,1340516501,1307,115,1422,1071,75.32%
Colorado,2020,General,DENVER,1340516502,1088,102,1190,796,66.89%
Colorado,2020,General,DENVER,1340516503,1376,202,1578,924,58.56%
Colorado,2020,General,DENVER,1340516504,1290,119,1409,921,65.37%
Colorado,2020,General,DENVER,1340516505,1287,114,1401,974,69.52%
Colorado,2020,General,DENVER,1340516506,1217,102,1319,1092,82.79%
Colorado,2020,General,DENVER,1340516507,1505,132,1637,1248,76.24%
Colorado,2020,General,DENVER,1340516508,1094,102,1196,1003,83.86%
Colorado,2020,General,DENVER,1340516509,1603,219,1822,1407,77.22%
Colorado,2020,General,DENVER,1340516510,965,203,1168,723,61.90%
Colorado,2020,General,DENVER,1340516511,1534,187,1721,1370,79.60%
Colorado,2020,General,DENVER,1340516512,1943,267,2210,1745,78.96%
Colorado,2020,General,DENVER,1340516513,1877,254,2131,1738,81.56%
Colorado,2020,General,DENVER,1340516514,1743,349,2092,1572,75.14%
Colorado,2020,General,DENVER,1340516515,2119,428,2547,1854,72.79%
Colorado,2020,General,DENVER,1340516517,957,135,1092,804,73.63%
Colorado,2020,General,DENVER,1340516518,893,150,1043,759,72.77%
Colorado,2020,General,DENVER,1340516519,1472,583,2055,1222,59.46%
Colorado,2020,General,DENVER,1340516522,2253,315,2568,1991,77.53%
Colorado,2020,General,DENVER,1340516523,1657,373,2030,1504,74.09%
Colorado,2020,General,DENVER,1340516524,1312,254,1566,1135,72.48%
Colorado,2020,General,DENVER,1340516525,1509,386,1895,1261,66.54%
Colorado,2020,General,DENVER,1340516526,1218,232,1450,905,62.41%
Colorado,2020,General,DENVER,1340516527,1650,396,2046,1182,57.77%
Colorado,2020,General,DENVER,1340516528,1609,282,1891,1318,69.70%
Colorado,2020,General,DENVER,1340516529,2565,375,2940,2305,78.40%
Colorado,2020,General,DENVER,1340516531,1849,199,2048,1306,63.77%
Colorado,2020,General,DENVER,1340516540,2267,379,2646,2037,76.98%
Colorado,2020,General,DENVER,1340516541,2148,325,2473,1868,75.54%
Colorado,2020,General,DENVER,1340516542,1261,243,1504,1119,74.40%
Colorado,2020,General,DENVER,1340516543,1191,159,1350,970,71.85%
Colorado,2020,General,DENVER,1340816809,1651,295,1946,1343,69.01%
Colorado,2020,General,DOLORES,3065817001,295,75,370,253,68.38%
Colorado,2020,General,DOLORES,3065817002,339,57,396,304,76.77%
Colorado,2020,General,DOLORES,3065817003,382,54,436,352,80.73%
Colorado,2020,General,DOLORES,3065817004,615,98,713,554,77.70%
Colorado,2020,General,DOUGLAS,4043918106,319,16,335,292,87.16%
Colorado,2020,General,DOUGLAS,4043918107,840,29,869,775,89.18%
Colorado,2020,General,DOUGLAS,4043918306,1117,57,1174,1036,88.25%
Colorado,2020,General,DOUGLAS,4043918317,1034,57,1091,939,86.07%
Colorado,2020,General,DOUGLAS,4043918332,1540,87,1627,1400,86.05%
Colorado,2020,General,DOUGLAS,4043918345,1297,53,1350,1179,87.33%
Colorado,2020,General,DOUGLAS,4043918346,1029,47,1076,954,88.66%
Colorado,2020,General,DOUGLAS,4043918358,726,32,758,663,87.47%
Colorado,2020,General,DOUGLAS,4043918401,1123,64,1187,1040,87.62%
Colorado,2020,General,DOUGLAS,4043918402,904,40,944,838,88.77%
Colorado,2020,General,DOUGLAS,4043918403,284,29,313,251,80.19%
Colorado,2020,General,DOUGLAS,4043918404,1721,103,1824,1586,86.95%
Colorado,2020,General,DOUGLAS,4043918405,1701,107,1808,1582,87.50%
Colorado,2020,General,DOUGLAS,4043918406,909,74,983,814,82.81%
Colorado,2020,General,DOUGLAS,4043918508,1891,115,2006,1757,87.59%
Colorado,2020,General,DOUGLAS,4043918511,1153,83,1236,1071,86.65%
Colorado,2020,General,DOUGLAS,4043918512,1534,115,1649,1411,85.57%
Colorado,2020,General,DOUGLAS,4044418302,2304,172,2476,2075,83.80%
Colorado,2020,General,DOUGLAS,4044418303,1186,136,1322,1012,76.55%
Colorado,2020,General,DOUGLAS,4044418304,2055,310,2365,1682,71.12%
Colorado,2020,General,DOUGLAS,4044418309,2126,308,2434,1795,73.75%
Colorado,2020,General,DOUGLAS,4044418315,1851,105,1956,1676,85.69%
Colorado,2020,General,DOUGLAS,4044418316,1277,149,1426,1133,79.45%
Colorado,2020,General,DOUGLAS,4044418318,1369,97,1466,1236,84.31%
Colorado,2020,General,DOUGLAS,4044418319,1141,109,1250,1021,81.68%
Colorado,2020,General,DOUGLAS,4044418320,1220,107,1327,1088,81.99%
Colorado,2020,General,DOUGLAS,4044418321,2017,188,2205,1774,80.45%
Colorado,2020,General,DOUGLAS,4044418322,1636,245,1881,1392,74.00%
Colorado,2020,General,DOUGLAS,4044418323,1127,88,1215,1021,84.03%
Colorado,2020,General,DOUGLAS,4044418324,1642,140,1782,1499,84.12%
Colorado,2020,General,DOUGLAS,4044418325,1256,88,1344,1120,83.33%
Colorado,2020,General,DOUGLAS,4044418326,1876,106,1982,1716,86.58%
Colorado,2020,General,DOUGLAS,4044418327,1613,111,1724,1463,84.86%
Colorado,2020,General,DOUGLAS,4044418328,1527,138,1665,1363,81.86%
Colorado,2020,General,DOUGLAS,4044418329,2138,125,2263,1936,85.55%
Colorado,2020,General,DOUGLAS,4044418330,2388,150,2538,2225,87.67%
Colorado,2020,General,DOUGLAS,4044418331,1904,139,2043,1769,86.59%
Colorado,2020,General,DOUGLAS,4044418334,1915,140,2055,1683,81.90%
Colorado,2020,General,DOUGLAS,4044418350,1611,155,1766,1387,78.54%
Colorado,2020,General,DOUGLAS,4044418352,1401,91,1492,1284,86.06%
Colorado,2020,General,DOUGLAS,4044418353,1535,134,1669,1355,81.19%
Colorado,2020,General,DOUGLAS,4044418356,1189,215,1404,987,70.30%
Colorado,2020,General,DOUGLAS,4044418357,1605,86,1691,1479,87.46%
Colorado,2020,General,DOUGLAS,4044518108,1494,89,1583,1286,81.24%
Colorado,2020,General,DOUGLAS,4044518109,1620,125,1745,1483,84.99%
Colorado,2020,General,DOUGLAS,4044518110,1829,187,2016,1616,80.16%
Colorado,2020,General,DOUGLAS,4044518111,1278,100,1378,1172,85.05%
Colorado,2020,General,DOUGLAS,4044518112,3367,219,3586,3070,85.61%
Colorado,2020,General,DOUGLAS,4044518113,1800,167,1967,1681,85.46%
Colorado,2020,General,DOUGLAS,4044518114,2133,184,2317,1955,84.38%
Colorado,2020,General,DOUGLAS,4044518116,1229,108,1337,1118,83.62%
Colorado,2020,General,DOUGLAS,4044518117,1798,165,1963,1618,82.42%
Colorado,2020,General,DOUGLAS,4044518118,1429,173,1602,1302,81.27%
Colorado,2020,General,DOUGLAS,4044518261,1639,124,1763,1544,87.58%
Colorado,2020,General,DOUGLAS,4044518262,2057,169,2226,1920,86.25%
Colorado,2020,General,DOUGLAS,4044518263,1931,115,2046,1782,87.10%
Colorado,2020,General,DOUGLAS,4044518264,1411,263,1674,1146,68.46%
Colorado,2020,General,DOUGLAS,4044518269,1448,117,1565,1349,86.20%
Colorado,2020,General,DOUGLAS,4044518333,1928,150,2078,1768,85.08%
Colorado,2020,General,DOUGLAS,4044518335,730,41,771,672,87.16%
Colorado,2020,General,DOUGLAS,4044518336,1404,110,1514,1304,86.13%
Colorado,2020,General,DOUGLAS,4044518337,1255,145,1400,1100,78.57%
Colorado,2020,General,DOUGLAS,4044518338,1146,82,1228,1058,86.16%
Colorado,2020,General,DOUGLAS,4044518339,1719,128,1847,1540,83.38%
Colorado,2020,General,DOUGLAS,4044518340,1526,109,1635,1398,85.50%
Colorado,2020,General,DOUGLAS,4044518341,1350,81,1431,1243,86.86%
Colorado,2020,General,DOUGLAS,4044518342,1782,107,1889,1654,87.56%
Colorado,2020,General,DOUGLAS,4044518343,1835,186,2021,1635,80.90%
Colorado,2020,General,DOUGLAS,4044518344,2898,130,3028,2655,87.68%
Colorado,2020,General,DOUGLAS,4044518347,916,94,1010,787,77.92%
Colorado,2020,General,DOUGLAS,4044518348,1851,178,2029,1654,81.52%
Colorado,2020,General,DOUGLAS,4044518349,1914,79,1993,1778,89.21%
Colorado,2020,General,DOUGLAS,4044518354,2675,152,2827,2474,87.51%
Colorado,2020,General,DOUGLAS,4044518359,1056,65,1121,961,85.73%
Colorado,2020,General,DOUGLAS,4044518360,1111,92,1203,1029,85.54%
Colorado,2020,General,DOUGLAS,4044518501,965,93,1058,810,76.56%
Colorado,2020,General,DOUGLAS,4044518502,1420,127,1547,1269,82.03%
Colorado,2020,General,DOUGLAS,4044518503,1692,184,1876,1456,77.61%
Colorado,2020,General,DOUGLAS,4044518504,1777,176,1953,1599,81.87%
Colorado,2020,General,DOUGLAS,4044518505,1636,169,1805,1461,80.94%
Colorado,2020,General,DOUGLAS,4044518506,1096,117,1213,962,79.31%
Colorado,2020,General,DOUGLAS,4044518507,1792,147,1939,1614,83.24%
Colorado,2020,General,DOUGLAS,4044518509,1850,124,1974,1710,86.63%
Colorado,2020,General,DOUGLAS,4044518510,3335,210,3545,3079,86.85%
Colorado,2020,General,DOUGLAS,4044518513,1773,222,1995,1576,79.00%
Colorado,2020,General,DOUGLAS,4044518514,1451,138,1589,1274,80.18%
Colorado,2020,General,DOUGLAS,4303918101,2750,91,2841,2522,88.77%
Colorado,2020,General,DOUGLAS,4303918102,2087,123,2210,1935,87.56%
Colorado,2020,General,DOUGLAS,4303918103,1867,144,2011,1692,84.14%
Colorado,2020,General,DOUGLAS,4303918104,640,40,680,570,83.82%
Colorado,2020,General,DOUGLAS,4303918105,1829,94,1923,1706,88.72%
Colorado,2020,General,DOUGLAS,4303918115,1432,95,1527,1333,87.30%
Colorado,2020,General,DOUGLAS,4304418206,1076,62,1138,996,87.52%
Colorado,2020,General,DOUGLAS,4304418207,1432,154,1586,1236,77.93%
Colorado,2020,General,DOUGLAS,4304418208,1674,377,2051,1388,67.67%
Colorado,2020,General,DOUGLAS,4304418232,1086,42,1128,1031,91.40%
Colorado,2020,General,DOUGLAS,4304418233,2163,138,2301,2011,87.40%
Colorado,2020,General,DOUGLAS,4304418245,2092,160,2252,1944,86.32%
Colorado,2020,General,DOUGLAS,4304418257,1520,293,1813,1306,72.04%
Colorado,2020,General,DOUGLAS,4304418266,1788,103,1891,1641,86.78%
Colorado,2020,General,DOUGLAS,4304418267,1090,90,1180,1014,85.93%
Colorado,2020,General,DOUGLAS,4304418301,2179,362,2541,1823,71.74%
Colorado,2020,General,DOUGLAS,4304418307,1750,138,1888,1554,82.31%
Colorado,2020,General,DOUGLAS,4304418308,1552,117,1669,1436,86.04%
Colorado,2020,General,DOUGLAS,4304418311,1463,235,1698,1250,73.62%
Colorado,2020,General,DOUGLAS,4304418312,1231,80,1311,1140,86.96%
Colorado,2020,General,DOUGLAS,4304418313,1110,46,1156,1030,89.10%
Colorado,2020,General,DOUGLAS,4304418314,1073,63,1136,984,86.62%
Colorado,2020,General,DOUGLAS,4304418351,1775,136,1911,1644,86.03%
Colorado,2020,General,DOUGLAS,4304418355,1710,102,1812,1556,85.87%
Colorado,2020,General,DOUGLAS,4304518258,1783,101,1884,1647,87.42%
Colorado,2020,General,DOUGLAS,4304518259,1710,109,1819,1600,87.96%
Colorado,2020,General,DOUGLAS,4304518260,1156,66,1222,1097,89.77%
Colorado,2020,General,DOUGLAS,4304518268,957,52,1009,897,88.90%
Colorado,2020,General,DOUGLAS,6043918305,2733,72,2805,2563,91.37%
Colorado,2020,General,DOUGLAS,6043918310,776,35,811,731,90.14%
Colorado,2020,General,DOUGLAS,6303918243,1814,90,1904,1697,89.13%
Colorado,2020,General,DOUGLAS,6303918247,1719,98,1817,1604,88.28%
Colorado,2020,General,DOUGLAS,6303918249,1533,76,1609,1446,89.87%
Colorado,2020,General,DOUGLAS,6303918250,1280,105,1385,1189,85.85%
Colorado,2020,General,DOUGLAS,6303918251,1761,129,1890,1595,84.39%
Colorado,2020,General,DOUGLAS,6303918252,1710,139,1849,1517,82.04%
Colorado,2020,General,DOUGLAS,6303918253,993,49,1042,922,88.48%
Colorado,2020,General,DOUGLAS,6303918254,1630,100,1730,1521,87.92%
Colorado,2020,General,DOUGLAS,6303918255,1156,95,1251,1053,84.17%
Colorado,2020,General,DOUGLAS,6303918256,1007,57,1064,917,86.18%
Colorado,2020,General,DOUGLAS,6303918265,1805,78,1883,1702,90.39%
Colorado,2020,General,DOUGLAS,6304318201,1788,74,1862,1661,89.21%
Colorado,2020,General,DOUGLAS,6304318202,2155,180,2335,1993,85.35%
Colorado,2020,General,DOUGLAS,6304318203,1406,85,1491,1278,85.71%
Colorado,2020,General,DOUGLAS,6304318204,1325,205,1530,1118,73.07%
Colorado,2020,General,DOUGLAS,6304318205,1854,318,2172,1635,75.28%
Colorado,2020,General,DOUGLAS,6304318209,1545,78,1623,1441,88.79%
Colorado,2020,General,DOUGLAS,6304318210,1706,173,1879,1565,83.29%
Colorado,2020,General,DOUGLAS,6304318211,1936,178,2114,1775,83.96%
Colorado,2020,General,DOUGLAS,6304318212,1400,73,1473,1279,86.83%
Colorado,2020,General,DOUGLAS,6304318213,1184,40,1224,1121,91.58%
Colorado,2020,General,DOUGLAS,6304318214,725,35,760,684,90.00%
Colorado,2020,General,DOUGLAS,6304318215,1185,65,1250,1084,86.72%
Colorado,2020,General,DOUGLAS,6304318216,907,27,934,845,90.47%
Colorado,2020,General,DOUGLAS,6304318217,1400,89,1489,1255,84.28%
Colorado,2020,General,DOUGLAS,6304318218,1112,34,1146,1050,91.62%
Colorado,2020,General,DOUGLAS,6304318219,1026,73,1099,936,85.17%
Colorado,2020,General,DOUGLAS,6304318220,1107,99,1206,1019,84.49%
Colorado,2020,General,DOUGLAS,6304318221,1018,34,1052,941,89.45%
Colorado,2020,General,DOUGLAS,6304318222,1598,104,1702,1436,84.37%
Colorado,2020,General,DOUGLAS,6304318223,1868,129,1997,1713,85.78%
Colorado,2020,General,DOUGLAS,6304318224,1715,97,1812,1588,87.64%
Colorado,2020,General,DOUGLAS,6304318225,2059,159,2218,1836,82.78%
Colorado,2020,General,DOUGLAS,6304318226,1244,64,1308,1171,89.53%
Colorado,2020,General,DOUGLAS,6304318227,1988,96,2084,1858,89.16%
Colorado,2020,General,DOUGLAS,6304318228,1049,69,1118,954,85.33%
Colorado,2020,General,DOUGLAS,6304318229,1251,74,1325,1158,87.40%
Colorado,2020,General,DOUGLAS,6304318230,1120,81,1201,1042,86.76%
Colorado,2020,General,DOUGLAS,6304318231,1632,98,1730,1491,86.18%
Colorado,2020,General,DOUGLAS,6304318234,1035,57,1092,964,88.28%
Colorado,2020,General,DOUGLAS,6304318235,1777,127,1904,1656,86.97%
Colorado,2020,General,DOUGLAS,6304318236,2029,133,2162,1884,87.14%
Colorado,2020,General,DOUGLAS,6304318237,1434,69,1503,1339,89.09%
Colorado,2020,General,DOUGLAS,6304318238,1350,52,1402,1246,88.87%
Colorado,2020,General,DOUGLAS,6304318239,2063,105,2168,1913,88.24%
Colorado,2020,General,DOUGLAS,6304318240,1371,176,1547,1216,78.60%
Colorado,2020,General,DOUGLAS,6304318241,1482,85,1567,1344,85.77%
Colorado,2020,General,DOUGLAS,6304318242,1080,107,1187,994,83.74%
Colorado,2020,General,DOUGLAS,6304318244,1501,82,1583,1391,87.87%
Colorado,2020,General,DOUGLAS,6304318246,1726,88,1814,1588,87.54%
Colorado,2020,General,DOUGLAS,6304318248,1152,52,1204,1073,89.12%
Colorado,2020,General,DOUGLAS,6304318270,1008,205,1213,880,72.55%
Colorado,2020,General,EAGLE,2052619001,210,23,233,178,76.39%
Colorado,2020,General,EAGLE,2052619002,843,141,984,713,72.46%
Colorado,2020,General,EAGLE,2052619003,804,132,936,690,73.72%
Colorado,2020,General,EAGLE,2052619011,695,137,832,572,68.75%
Colorado,2020,General,EAGLE,2052619012,1523,247,1770,1295,73.16%
Colorado,2020,General,EAGLE,2052619013,1080,150,1230,914,74.31%
Colorado,2020,General,EAGLE,2052619014,741,88,829,660,79.61%
Colorado,2020,General,EAGLE,2052619015,1520,299,1819,1224,67.29%
Colorado,2020,General,EAGLE,2052619019,1536,211,1747,1308,74.87%
Colorado,2020,General,EAGLE,3052619004,1082,78,1160,947,81.64%
Colorado,2020,General,EAGLE,3052619005,2051,213,2264,1779,78.58%
Colorado,2020,General,EAGLE,3052619006,965,88,1053,797,75.69%
Colorado,2020,General,EAGLE,3052619007,1285,95,1380,1158,83.91%
Colorado,2020,General,EAGLE,3052619008,709,56,765,578,75.56%
Colorado,2020,General,EAGLE,3052619009,1215,118,1333,1005,75.39%
Colorado,2020,General,EAGLE,3052619010,165,16,181,149,82.32%
Colorado,2020,General,EAGLE,3052619016,710,50,760,646,85.00%
Colorado,2020,General,EAGLE,3052619017,888,134,1022,776,75.93%
Colorado,2020,General,EAGLE,3052619018,910,133,1043,771,73.92%
Colorado,2020,General,EAGLE,3052619020,1463,112,1575,1307,82.98%
Colorado,2020,General,EAGLE,3052619021,317,29,346,283,81.79%
Colorado,2020,General,EAGLE,3052619022,1643,188,1831,1255,68.54%
Colorado,2020,General,EAGLE,3052619023,1702,167,1869,1368,73.19%
Colorado,2020,General,EAGLE,3052619024,1777,173,1950,1538,78.87%
Colorado,2020,General,EAGLE,3052619025,1461,80,1541,1338,86.83%
Colorado,2020,General,EAGLE,3052619026,1410,124,1534,1223,79.73%
Colorado,2020,General,EAGLE,3052619027,1990,170,2160,1836,85.00%
Colorado,2020,General,EAGLE,3052619028,1003,72,1075,884,82.23%
Colorado,2020,General,EAGLE,3052619029,1389,174,1563,1218,77.93%
Colorado,2020,General,EAGLE,3052619030,1154,75,1229,1061,86.33%
Colorado,2020,General,EL PASO,5021821745,285,26,311,263,84.57%
Colorado,2020,General,EL PASO,5021921452,1710,141,1851,1468,79.31%
Colorado,2020,General,EL PASO,5021921500,445,45,490,380,77.55%
Colorado,2020,General,EL PASO,5021921501,1174,123,1297,996,76.79%
Colorado,2020,General,EL PASO,5021921502,1009,80,1089,859,78.88%
Colorado,2020,General,EL PASO,5021921521,1439,216,1655,1122,67.79%
Colorado,2020,General,EL PASO,5021921522,1561,148,1709,1320,77.24%
Colorado,2020,General,EL PASO,5021921523,1286,124,1410,1137,80.64%
Colorado,2020,General,EL PASO,5021921524,1716,127,1843,1535,83.29%
Colorado,2020,General,EL PASO,5021921554,189,8,197,158,80.20%
Colorado,2020,General,EL PASO,5021921560,1483,151,1634,1190,72.83%
Colorado,2020,General,EL PASO,5021921653,237,7,244,213,87.30%
Colorado,2020,General,EL PASO,5021921828,541,57,598,443,74.08%
Colorado,2020,General,EL PASO,5022021740,2096,196,2292,1865,81.37%
Colorado,2020,General,EL PASO,5022121632,2320,385,2705,1740,64.33%
Colorado,2020,General,EL PASO,5022121639,1243,299,1542,929,60.25%
Colorado,2020,General,EL PASO,5022121645,1152,143,1295,896,69.19%
Colorado,2020,General,EL PASO,5022121652,1674,129,1803,1405,77.93%
Colorado,2020,General,EL PASO,5022121801,1515,246,1761,1072,60.87%
Colorado,2020,General,EL PASO,5022121802,1550,190,1740,1175,67.53%
Colorado,2020,General,EL PASO,5022121803,1655,264,1919,1207,62.90%
Colorado,2020,General,EL PASO,5022121804,1264,191,1455,995,68.38%
Colorado,2020,General,EL PASO,5022121805,1659,225,1884,1314,69.75%
Colorado,2020,General,EL PASO,5022121806,1180,167,1347,951,70.60%
Colorado,2020,General,EL PASO,5022121807,1559,221,1780,1146,64.38%
Colorado,2020,General,EL PASO,5022121808,1769,327,2096,1335,63.69%
Colorado,2020,General,EL PASO,5022121839,1075,131,1206,885,73.38%
Colorado,2020,General,EL PASO,5091421215,1182,118,1300,1088,83.69%
Colorado,2020,General,EL PASO,5091421216,1774,186,1960,1531,78.11%
Colorado,2020,General,EL PASO,5091421217,1324,70,1394,1224,87.80%
Colorado,2020,General,EL PASO,5091421220,2202,158,2360,1979,83.86%
Colorado,2020,General,EL PASO,5091421221,1893,152,2045,1679,82.10%
Colorado,2020,General,EL PASO,5091421222,966,85,1051,864,82.21%
Colorado,2020,General,EL PASO,5091421223,2063,170,2233,1870,83.74%
Colorado,2020,General,EL PASO,5091421224,1939,193,2132,1697,79.60%
Colorado,2020,General,EL PASO,5091421225,1427,128,1555,1213,78.01%
Colorado,2020,General,EL PASO,5091421227,1744,134,1878,1567,83.44%
Colorado,2020,General,EL PASO,5091421228,1004,124,1128,883,78.28%
Colorado,2020,General,EL PASO,5091421229,2009,59,2068,1851,89.51%
Colorado,2020,General,EL PASO,5091421230,1794,111,1905,1624,85.25%
Colorado,2020,General,EL PASO,5091421231,1843,180,2023,1632,80.67%
Colorado,2020,General,EL PASO,5091421232,1675,202,1877,1471,78.37%
Colorado,2020,General,EL PASO,5091421233,1738,150,1888,1538,81.46%
Colorado,2020,General,EL PASO,5091421234,1768,122,1890,1598,84.55%
Colorado,2020,General,EL PASO,5091421236,1237,115,1352,1092,80.77%
Colorado,2020,General,EL PASO,5091421237,1338,155,1493,1141,76.42%
Colorado,2020,General,EL PASO,5091421238,1376,131,1507,1192,79.10%
Colorado,2020,General,EL PASO,5091421246,1456,203,1659,1183,71.31%
Colorado,2020,General,EL PASO,5091421247,1217,118,1335,1043,78.13%
Colorado,2020,General,EL PASO,5091421249,1269,99,1368,1128,82.46%
Colorado,2020,General,EL PASO,5091421250,1457,144,1601,1289,80.51%
Colorado,2020,General,EL PASO,5091521445,2009,210,2219,1699,76.57%
Colorado,2020,General,EL PASO,5091521454,2028,174,2202,1748,79.38%
Colorado,2020,General,EL PASO,5091821107,1872,276,2148,1460,67.97%
Colorado,2020,General,EL PASO,5091821108,1356,81,1437,1197,83.30%
Colorado,2020,General,EL PASO,5091821109,229,25,254,198,77.95%
Colorado,2020,General,EL PASO,5091921209,1621,109,1730,1488,86.01%
Colorado,2020,General,EL PASO,5091921210,1732,156,1888,1557,82.47%
Colorado,2020,General,EL PASO,5091921211,1435,163,1598,1294,80.98%
Colorado,2020,General,EL PASO,5091921212,1815,146,1961,1669,85.11%
Colorado,2020,General,EL PASO,5091921213,1529,93,1622,1391,85.76%
Colorado,2020,General,EL PASO,5091921214,1828,111,1939,1660,85.61%
Colorado,2020,General,EL PASO,5091921218,1145,69,1214,1040,85.67%
Colorado,2020,General,EL PASO,5091921219,1676,73,1749,1519,86.85%
Colorado,2020,General,EL PASO,5091921303,1806,121,1927,1631,84.64%
Colorado,2020,General,EL PASO,5091921304,1613,120,1733,1434,82.75%
Colorado,2020,General,EL PASO,5091921310,1874,112,1986,1744,87.81%
Colorado,2020,General,EL PASO,5091921311,1988,126,2114,1818,86.00%
Colorado,2020,General,EL PASO,5091921312,1955,139,2094,1797,85.82%
Colorado,2020,General,EL PASO,5091921313,1693,170,1863,1528,82.02%
Colorado,2020,General,EL PASO,5091921314,1544,105,1649,1431,86.78%
Colorado,2020,General,EL PASO,5091921315,1460,107,1567,1342,85.64%
Colorado,2020,General,EL PASO,5091921316,1414,80,1494,1308,87.55%
Colorado,2020,General,EL PASO,5091921317,2030,118,2148,1865,86.82%
Colorado,2020,General,EL PASO,5091921318,1938,88,2026,1792,88.45%
Colorado,2020,General,EL PASO,5091921319,1655,201,1856,1466,78.99%
Colorado,2020,General,EL PASO,5091921320,1711,102,1813,1555,85.77%
Colorado,2020,General,EL PASO,5091921321,1810,109,1919,1671,87.08%
Colorado,2020,General,EL PASO,5091921322,1585,115,1700,1446,85.06%
Colorado,2020,General,EL PASO,5091921440,1819,93,1912,1652,86.40%
Colorado,2020,General,EL PASO,5091921441,1433,119,1552,1304,84.02%
Colorado,2020,General,EL PASO,5091921442,2390,177,2567,2098,81.73%
Colorado,2020,General,EL PASO,5091921443,1514,175,1689,1280,75.78%
Colorado,2020,General,EL PASO,5091921444,2073,145,2218,1810,81.61%
Colorado,2020,General,EL PASO,5091921446,2537,274,2811,2205,78.44%
Colorado,2020,General,EL PASO,5091921447,1596,212,1808,1347,74.50%
Colorado,2020,General,EL PASO,5091921448,1584,212,1796,1334,74.28%
Colorado,2020,General,EL PASO,5091921449,1409,187,1596,1189,74.50%
Colorado,2020,General,EL PASO,5091921450,1633,131,1764,1459,82.71%
Colorado,2020,General,EL PASO,5091921525,236,19,255,213,83.53%
Colorado,2020,General,EL PASO,5092021101,1729,194,1923,1486,77.28%
Colorado,2020,General,EL PASO,5092021102,1813,107,1920,1689,87.97%
Colorado,2020,General,EL PASO,5092021103,1809,291,2100,1601,76.24%
Colorado,2020,General,EL PASO,5092021104,2140,230,2370,1901,80.21%
Colorado,2020,General,EL PASO,5092021105,1552,84,1636,1466,89.61%
Colorado,2020,General,EL PASO,5092021106,1829,268,2097,1548,73.82%
Colorado,2020,General,EL PASO,5092021116,1748,130,1878,1615,86.00%
Colorado,2020,General,EL PASO,5092021117,1652,245,1897,1361,71.74%
Colorado,2020,General,EL PASO,5092021200,792,434,1226,581,47.39%
Colorado,2020,General,EL PASO,5092021201,1869,110,1979,1712,86.51%
Colorado,2020,General,EL PASO,5092021202,1709,114,1823,1560,85.57%
Colorado,2020,General,EL PASO,5092021203,1543,99,1642,1408,85.75%
Colorado,2020,General,EL PASO,5092021204,1727,124,1851,1553,83.90%
Colorado,2020,General,EL PASO,5092021205,1923,212,2135,1690,79.16%
Colorado,2020,General,EL PASO,5092021206,1335,151,1486,1146,77.12%
Colorado,2020,General,EL PASO,5092021207,889,132,1021,766,75.02%
Colorado,2020,General,EL PASO,5092021208,1690,119,1809,1552,85.79%
Colorado,2020,General,EL PASO,5092021226,1079,146,1225,921,75.18%
Colorado,2020,General,EL PASO,5092021248,1251,88,1339,1139,85.06%
Colorado,2020,General,EL PASO,5092021301,982,55,1037,916,88.33%
Colorado,2020,General,EL PASO,5092021302,2096,204,2300,1875,81.52%
Colorado,2020,General,EL PASO,5092021741,536,37,573,497,86.74%
Colorado,2020,General,EL PASO,5101421134,1261,226,1487,1077,72.43%
Colorado,2020,General,EL PASO,5101421135,701,130,831,589,70.88%
Colorado,2020,General,EL PASO,5101421141,1643,216,1859,1379,74.18%
Colorado,2020,General,EL PASO,5101421142,2020,178,2198,1780,80.98%
Colorado,2020,General,EL PASO,5101421143,1041,122,1163,931,80.05%
Colorado,2020,General,EL PASO,5101421144,1579,135,1714,1375,80.22%
Colorado,2020,General,EL PASO,5101421145,1925,166,2091,1668,79.77%
Colorado,2020,General,EL PASO,5101421146,1021,117,1138,913,80.23%
Colorado,2020,General,EL PASO,5101421163,1541,310,1851,1267,68.45%
Colorado,2020,General,EL PASO,5101421164,1703,175,1878,1474,78.49%
Colorado,2020,General,EL PASO,5101421235,1843,187,2030,1617,79.66%
Colorado,2020,General,EL PASO,5101421239,1713,269,1982,1473,74.32%
Colorado,2020,General,EL PASO,5101421240,1762,173,1935,1504,77.73%
Colorado,2020,General,EL PASO,5101421241,2150,181,2331,1852,79.45%
Colorado,2020,General,EL PASO,5101421242,2041,359,2400,1710,71.25%
Colorado,2020,General,EL PASO,5101421243,2027,219,2246,1687,75.11%
Colorado,2020,General,EL PASO,5101421244,1956,259,2215,1694,76.48%
Colorado,2020,General,EL PASO,5101421245,1760,191,1951,1550,79.45%
Colorado,2020,General,EL PASO,5101521159,395,31,426,337,79.11%
Colorado,2020,General,EL PASO,5101521401,1824,217,2041,1564,76.63%
Colorado,2020,General,EL PASO,5101521402,2123,285,2408,1768,73.42%
Colorado,2020,General,EL PASO,5101521403,1750,194,1944,1559,80.20%
Colorado,2020,General,EL PASO,5101521404,1693,270,1963,1337,68.11%
Colorado,2020,General,EL PASO,5101521405,1506,187,1693,1273,75.19%
Colorado,2020,General,EL PASO,5101521406,1740,228,1968,1458,74.09%
Colorado,2020,General,EL PASO,5101521407,1809,226,2035,1569,77.10%
Colorado,2020,General,EL PASO,5101521408,2026,234,2260,1787,79.07%
Colorado,2020,General,EL PASO,5101521417,1675,213,1888,1358,71.93%
Colorado,2020,General,EL PASO,5101521423,1530,111,1641,1330,81.05%
Colorado,2020,General,EL PASO,5101621099,1076,173,1249,852,68.21%
Colorado,2020,General,EL PASO,5101621120,1158,103,1261,1026,81.36%
Colorado,2020,General,EL PASO,5101621121,2154,302,2456,1808,73.62%
Colorado,2020,General,EL PASO,5101621122,2220,482,2702,1620,59.96%
Colorado,2020,General,EL PASO,5101621123,1277,119,1396,1032,73.93%
Colorado,2020,General,EL PASO,5101621124,846,247,1093,714,65.32%
Colorado,2020,General,EL PASO,5101621125,1945,207,2152,1656,76.95%
Colorado,2020,General,EL PASO,5101621126,2127,236,2363,1748,73.97%
Colorado,2020,General,EL PASO,5101621127,2028,152,2180,1744,80.00%
Colorado,2020,General,EL PASO,5101621128,1891,169,2060,1676,81.36%
Colorado,2020,General,EL PASO,5101621129,2183,503,2686,1669,62.14%
Colorado,2020,General,EL PASO,5101621130,1643,208,1851,1404,75.85%
Colorado,2020,General,EL PASO,5101621131,1781,162,1943,1505,77.46%
Colorado,2020,General,EL PASO,5101621132,1627,85,1712,1415,82.65%
Colorado,2020,General,EL PASO,5101621136,1344,209,1553,1185,76.30%
Colorado,2020,General,EL PASO,5101621138,994,148,1142,857,75.04%
Colorado,2020,General,EL PASO,5101621140,1601,145,1746,1399,80.13%
Colorado,2020,General,EL PASO,5101621147,1674,241,1915,1417,73.99%
Colorado,2020,General,EL PASO,5101621148,2097,252,2349,1754,74.67%
Colorado,2020,General,EL PASO,5101621149,1879,175,2054,1670,81.30%
Colorado,2020,General,EL PASO,5101621150,1625,98,1723,1427,82.82%
Colorado,2020,General,EL PASO,5101621151,2028,182,2210,1795,81.22%
Colorado,2020,General,EL PASO,5101621152,1947,225,2172,1581,72.79%
Colorado,2020,General,EL PASO,5101621153,1951,165,2116,1668,78.83%
Colorado,2020,General,EL PASO,5101621154,2142,396,2538,1652,65.09%
Colorado,2020,General,EL PASO,5101621157,1630,191,1821,1356,74.46%
Colorado,2020,General,EL PASO,5101621160,1870,209,2079,1575,75.76%
Colorado,2020,General,EL PASO,5101621165,1885,136,2021,1707,84.46%
Colorado,2020,General,EL PASO,5101621166,2012,379,2391,1487,62.19%
Colorado,2020,General,EL PASO,5101621175,1135,96,1231,960,77.99%
Colorado,2020,General,EL PASO,5101621198,1083,140,1223,848,69.34%
Colorado,2020,General,EL PASO,5101821171,1438,119,1557,1300,83.49%
Colorado,2020,General,EL PASO,5101821174,1015,181,1196,807,67.47%
Colorado,2020,General,EL PASO,5101821181,222,21,243,185,76.13%
Colorado,2020,General,EL PASO,5101821197,1135,116,1251,948,75.78%
Colorado,2020,General,EL PASO,5111721137,964,166,1130,668,59.12%
Colorado,2020,General,EL PASO,5111721182,1733,232,1965,1256,63.92%
Colorado,2020,General,EL PASO,5111721183,1123,301,1424,842,59.13%
Colorado,2020,General,EL PASO,5111721184,1286,414,1700,836,49.18%
Colorado,2020,General,EL PASO,5111721187,1629,297,1926,1264,65.63%
Colorado,2020,General,EL PASO,5111721190,1098,303,1401,771,55.03%
Colorado,2020,General,EL PASO,5111721193,1249,301,1550,927,59.81%
Colorado,2020,General,EL PASO,5111721194,1147,194,1341,827,61.67%
Colorado,2020,General,EL PASO,5111721199,1042,222,1264,751,59.41%
Colorado,2020,General,EL PASO,5111721610,2120,409,2529,1603,63.38%
Colorado,2020,General,EL PASO,5111721611,1947,287,2234,1405,62.89%
Colorado,2020,General,EL PASO,5111721612,1818,428,2246,1309,58.28%
Colorado,2020,General,EL PASO,5111721613,1911,302,2213,1436,64.89%
Colorado,2020,General,EL PASO,5111721614,1947,596,2543,1303,51.24%
Colorado,2020,General,EL PASO,5111721615,1233,183,1416,822,58.05%
Colorado,2020,General,EL PASO,5111721616,1652,237,1889,1186,62.78%
Colorado,2020,General,EL PASO,5111721619,1204,236,1440,869,60.35%
Colorado,2020,General,EL PASO,5111721620,928,116,1044,742,71.07%
Colorado,2020,General,EL PASO,5111721621,2080,351,2431,1525,62.73%
Colorado,2020,General,EL PASO,5111721622,2025,391,2416,1443,59.73%
Colorado,2020,General,EL PASO,5111721623,2276,323,2599,1680,64.64%
Colorado,2020,General,EL PASO,5111721624,1931,252,2183,1380,63.22%
Colorado,2020,General,EL PASO,5111721625,1978,298,2276,1475,64.81%
Colorado,2020,General,EL PASO,5111721626,1080,615,1695,684,40.35%
Colorado,2020,General,EL PASO,5111721627,1285,211,1496,996,66.58%
Colorado,2020,General,EL PASO,5111721901,792,154,946,580,61.31%
Colorado,2020,General,EL PASO,5111821110,1716,289,2005,1325,66.08%
Colorado,2020,General,EL PASO,5111821111,1361,241,1602,1097,68.48%
Colorado,2020,General,EL PASO,5111821112,1801,315,2116,1469,69.42%
Colorado,2020,General,EL PASO,5111821113,1647,204,1851,1381,74.61%
Colorado,2020,General,EL PASO,5111821114,2039,220,2259,1765,78.13%
Colorado,2020,General,EL PASO,5111821118,1936,284,2220,1582,71.26%
Colorado,2020,General,EL PASO,5111821119,1681,232,1913,1378,72.03%
Colorado,2020,General,EL PASO,5111821133,1058,98,1156,904,78.20%
Colorado,2020,General,EL PASO,5111821168,1507,157,1664,1339,80.47%
Colorado,2020,General,EL PASO,5111821169,1997,524,2521,1210,48.00%
Colorado,2020,General,EL PASO,5111821170,1671,222,1893,1405,74.22%
Colorado,2020,General,EL PASO,5111821172,1500,150,1650,1345,81.52%
Colorado,2020,General,EL PASO,5111821173,1718,234,1952,1457,74.64%
Colorado,2020,General,EL PASO,5111821176,1476,873,2349,1192,50.74%
Colorado,2020,General,EL PASO,5111821177,1530,558,2088,1200,57.47%
Colorado,2020,General,EL PASO,5111821178,1611,203,1814,1347,74.26%
Colorado,2020,General,EL PASO,5111821179,1630,208,1838,1439,78.29%
Colorado,2020,General,EL PASO,5111821180,1950,343,2293,1431,62.41%
Colorado,2020,General,EL PASO,5111821185,1686,321,2007,1260,62.78%
Colorado,2020,General,EL PASO,5111821186,1926,366,2292,1396,60.91%
Colorado,2020,General,EL PASO,5111821188,1877,300,2177,1482,68.08%
Colorado,2020,General,EL PASO,5111821189,1641,312,1953,1255,64.26%
Colorado,2020,General,EL PASO,5111821742,1300,195,1495,1111,74.31%
Colorado,2020,General,EL PASO,5111821743,1423,196,1619,1230,75.97%
Colorado,2020,General,EL PASO,5111821744,1286,117,1403,1148,81.82%
Colorado,2020,General,EL PASO,5112021601,1371,205,1576,1021,64.78%
Colorado,2020,General,EL PASO,5112021605,1584,259,1843,1121,60.82%
Colorado,2020,General,EL PASO,5121521139,1405,259,1664,1047,62.92%
Colorado,2020,General,EL PASO,5121521158,1744,165,1909,1512,79.20%
Colorado,2020,General,EL PASO,5121521161,1794,137,1931,1604,83.07%
Colorado,2020,General,EL PASO,5121521162,1506,134,1640,1283,78.23%
Colorado,2020,General,EL PASO,5121521167,1566,151,1717,1319,76.82%
Colorado,2020,General,EL PASO,5121521191,1949,256,2205,1617,73.33%
Colorado,2020,General,EL PASO,5121521192,1904,167,2071,1543,74.51%
Colorado,2020,General,EL PASO,5121521195,1641,216,1857,1239,66.72%
Colorado,2020,General,EL PASO,5121521196,473,313,786,311,39.57%
Colorado,2020,General,EL PASO,5121521409,1653,147,1800,1451,80.61%
Colorado,2020,General,EL PASO,5121521410,1821,238,2059,1582,76.83%
Colorado,2020,General,EL PASO,5121521411,2058,243,2301,1764,76.66%
Colorado,2020,General,EL PASO,5121521412,1419,191,1610,1208,75.03%
Colorado,2020,General,EL PASO,5121521413,1655,208,1863,1399,75.09%
Colorado,2020,General,EL PASO,5121521414,1511,202,1713,1217,71.04%
Colorado,2020,General,EL PASO,5121521415,1574,222,1796,1251,69.65%
Colorado,2020,General,EL PASO,5121521416,1691,218,1909,1431,74.96%
Colorado,2020,General,EL PASO,5121521418,1495,144,1639,1201,73.28%
Colorado,2020,General,EL PASO,5121521419,1549,180,1729,1274,73.68%
Colorado,2020,General,EL PASO,5121521420,2641,166,2807,2333,83.11%
Colorado,2020,General,EL PASO,5121521421,1281,190,1471,1059,71.99%
Colorado,2020,General,EL PASO,5121521422,1214,197,1411,1001,70.94%
Colorado,2020,General,EL PASO,5121521424,2338,210,2548,2047,80.34%
Colorado,2020,General,EL PASO,5121521650,1984,344,2328,1494,64.18%
Colorado,2020,General,EL PASO,5121621155,1415,156,1571,1175,74.79%
Colorado,2020,General,EL PASO,5121621156,1092,81,1173,932,79.45%
Colorado,2020,General,EL PASO,5121721631,629,108,737,469,63.64%
Colorado,2020,General,EL PASO,5121821115,1020,136,1156,856,74.05%
Colorado,2020,General,EL PASO,5121821720,1288,225,1513,1044,69.00%
Colorado,2020,General,EL PASO,5121821721,1649,118,1767,1526,86.36%
Colorado,2020,General,EL PASO,5121821722,1765,90,1855,1620,87.33%
Colorado,2020,General,EL PASO,5121821723,1978,326,2304,1618,70.23%
Colorado,2020,General,EL PASO,5121821724,918,160,1078,749,69.48%
Colorado,2020,General,EL PASO,5121921451,1602,175,1777,1362,76.65%
Colorado,2020,General,EL PASO,5121921453,1564,121,1685,1351,80.18%
Colorado,2020,General,EL PASO,5121921520,155,14,169,139,82.25%
Colorado,2020,General,EL PASO,5121921651,3118,417,3535,2385,67.47%
Colorado,2020,General,EL PASO,5122021602,1341,148,1489,1191,79.99%
Colorado,2020,General,EL PASO,5122021603,1375,286,1661,1096,65.98%
Colorado,2020,General,EL PASO,5122021604,1548,600,2148,1093,50.88%
Colorado,2020,General,EL PASO,5122021606,1583,200,1783,1341,75.21%
Colorado,2020,General,EL PASO,5122021725,2055,218,2273,1799,79.15%
Colorado,2020,General,EL PASO,5122021726,1744,80,1824,1613,88.43%
Colorado,2020,General,EL PASO,5122021727,1721,105,1826,1572,86.09%
Colorado,2020,General,EL PASO,5122021728,1891,199,2090,1730,82.78%
Colorado,2020,General,EL PASO,5122021729,1949,142,2091,1779,85.08%
Colorado,2020,General,EL PASO,5122021730,1808,203,2011,1546,76.88%
Colorado,2020,General,EL PASO,5122121630,1884,238,2122,1481,69.79%
Colorado,2020,General,EL PASO,5122121633,1877,214,2091,1472,70.40%
Colorado,2020,General,EL PASO,5122121634,1970,190,2160,1568,72.59%
Colorado,2020,General,EL PASO,5122121635,2139,261,2400,1687,70.29%
Colorado,2020,General,EL PASO,5122121636,1122,115,1237,880,71.14%
Colorado,2020,General,EL PASO,5122121637,1964,257,2221,1518,68.35%
Colorado,2020,General,EL PASO,5122121638,1533,167,1700,1185,69.71%
Colorado,2020,General,EL PASO,5122121640,1635,245,1880,1267,67.39%
Colorado,2020,General,EL PASO,5122121641,1691,171,1862,1373,73.74%
Colorado,2020,General,EL PASO,5122121642,1278,135,1413,1013,71.69%
Colorado,2020,General,EL PASO,5122121643,1526,166,1692,1221,72.16%
Colorado,2020,General,EL PASO,5122121644,1561,167,1728,1195,69.16%
Colorado,2020,General,EL PASO,5122121646,1037,106,1143,823,72.00%
Colorado,2020,General,EL PASO,5122121648,1078,232,1310,829,63.28%
Colorado,2020,General,EL PASO,5122121800,2306,1913,4219,1287,30.50%
Colorado,2020,General,ELBERT,4016420001,1176,113,1289,1036,80.37%
Colorado,2020,General,ELBERT,4016420002,1715,138,1853,1554,83.86%
Colorado,2020,General,ELBERT,4016420003,1456,108,1564,1349,86.25%
Colorado,2020,General,ELBERT,4016420004,1592,141,1733,1452,83.79%
Colorado,2020,General,ELBERT,4016420005,1146,76,1222,1063,86.99%
Colorado,2020,General,ELBERT,4016420006,1739,136,1875,1575,84.00%
Colorado,2020,General,ELBERT,4016420007,1783,111,1894,1615,85.27%
Colorado,2020,General,ELBERT,4016420008,821,49,870,751,86.32%
Colorado,2020,General,ELBERT,4016420009,1686,126,1812,1557,85.93%
Colorado,2020,General,ELBERT,4016420010,1396,89,1485,1298,87.41%
Colorado,2020,General,ELBERT,4016420011,1237,104,1341,1125,83.89%
Colorado,2020,General,ELBERT,4016420012,1484,131,1615,1341,83.03%
Colorado,2020,General,ELBERT,4016420013,1074,86,1160,1011,87.16%
Colorado,2020,General,ELBERT,4016420014,1636,152,1788,1463,81.82%
Colorado,2020,General,ELBERT,4016420015,1072,103,1175,941,80.09%
Colorado,2020,General,FREMONT,5024722001,1119,98,1217,944,77.57%
Colorado,2020,General,FREMONT,5024722002,1255,136,1391,1043,74.98%
Colorado,2020,General,FREMONT,5024722003,1230,100,1330,1086,81.65%
Colorado,2020,General,FREMONT,5024722025,225,27,252,166,65.87%
Colorado,2020,General,FREMONT,5024722026,592,27,619,524,84.65%
Colorado,2020,General,FREMONT,5024722028,237,14,251,209,83.27%
Colorado,2020,General,FREMONT,5026022004,1103,116,1219,918,75.31%
Colorado,2020,General,FREMONT,5026022005,820,91,911,666,73.11%
Colorado,2020,General,FREMONT,5026022006,808,72,880,675,76.70%
Colorado,2020,General,FREMONT,5026022007,1760,141,1901,1476,77.64%
Colorado,2020,General,FREMONT,5026022008,860,65,925,721,77.95%
Colorado,2020,General,FREMONT,5026022009,918,69,987,827,83.79%
Colorado,2020,General,FREMONT,5026022010,1310,102,1412,1144,81.02%
Colorado,2020,General,FREMONT,5026022011,1689,142,1831,1559,85.14%
Colorado,2020,General,FREMONT,5026022012,1679,207,1886,1366,72.43%
Colorado,2020,General,FREMONT,5026022013,1102,143,1245,936,75.18%
Colorado,2020,General,FREMONT,5026022014,869,59,928,755,81.36%
Colorado,2020,General,FREMONT,5026022015,690,63,753,606,80.48%
Colorado,2020,General,FREMONT,5026022016,938,98,1036,814,78.57%
Colorado,2020,General,FREMONT,5026022017,923,91,1014,796,78.50%
Colorado,2020,General,FREMONT,5026022018,1345,143,1488,1097,73.72%
Colorado,2020,General,FREMONT,5026022019,1880,203,2083,1552,74.51%
Colorado,2020,General,FREMONT,5026022020,1444,168,1612,1215,75.37%
Colorado,2020,General,FREMONT,5026022021,667,85,752,582,77.39%
Colorado,2020,General,FREMONT,5026022022,1794,205,1999,1534,76.74%
Colorado,2020,General,FREMONT,5026022023,467,29,496,437,88.10%
Colorado,2020,General,FREMONT,5026022024,728,62,790,663,83.92%
Colorado,2020,General,FREMONT,5026022027,268,16,284,234,82.39%
Colorado,2020,General,FREMONT,5026022029,589,39,628,527,83.92%
Colorado,2020,General,FREMONT,5026022030,891,157,1048,719,68.61%
Colorado,2020,General,GARFIELD,3085723001,1774,221,1995,1518,76.09%
Colorado,2020,General,GARFIELD,3085723002,1735,99,1834,1613,87.95%
Colorado,2020,General,GARFIELD,3085723003,1777,172,1949,1572,80.66%
Colorado,2020,General,GARFIELD,3085723004,1710,139,1849,1553,83.99%
Colorado,2020,General,GARFIELD,3085723005,1694,192,1886,1505,79.80%
Colorado,2020,General,GARFIELD,3085723006,1112,151,1263,936,74.11%
Colorado,2020,General,GARFIELD,3085723007,902,124,1026,770,75.05%
Colorado,2020,General,GARFIELD,3085723008,956,135,1091,824,75.53%
Colorado,2020,General,GARFIELD,3085723009,1166,108,1274,1051,82.50%
Colorado,2020,General,GARFIELD,3085723010,1872,171,2043,1677,82.09%
Colorado,2020,General,GARFIELD,3085723011,979,87,1066,885,83.02%
Colorado,2020,General,GARFIELD,3085723012,1408,134,1542,1170,75.88%
Colorado,2020,General,GARFIELD,3085723013,899,113,1012,705,69.66%
Colorado,2020,General,GARFIELD,3085723014,1766,188,1954,1532,78.40%
Colorado,2020,General,GARFIELD,3085723015,1667,192,1859,1468,78.97%
Colorado,2020,General,GARFIELD,3085723016,1784,184,1968,1498,76.12%
Colorado,2020,General,GARFIELD,3085723017,1415,150,1565,1240,79.23%
Colorado,2020,General,GARFIELD,3085723018,759,47,806,666,82.63%
Colorado,2020,General,GARFIELD,3085723019,1692,151,1843,1377,74.72%
Colorado,2020,General,GARFIELD,3085723020,1402,196,1598,1180,73.84%
Colorado,2020,General,GARFIELD,3085723021,1486,172,1658,1261,76.06%
Colorado,2020,General,GARFIELD,3085723022,1313,190,1503,1030,68.53%
Colorado,2020,General,GARFIELD,3085723023,1080,187,1267,859,67.80%
Colorado,2020,General,GARFIELD,3085723024,569,51,620,504,81.29%
Colorado,2020,General,GARFIELD,3085723025,838,160,998,637,63.83%
Colorado,2020,General,GARFIELD,3085723026,1591,258,1849,1301,70.36%
Colorado,2020,General,GARFIELD,3085723027,1235,170,1405,913,64.98%
Colorado,2020,General,GILPIN,2161324001,726,222,948,606,63.92%
Colorado,2020,General,GILPIN,2161324002,812,91,903,734,81.28%
Colorado,2020,General,GILPIN,2161324003,965,133,1098,881,80.24%
Colorado,2020,General,GILPIN,2161324004,751,130,881,638,72.42%
Colorado,2020,General,GILPIN,2161324005,727,102,829,620,74.79%
Colorado,2020,General,GILPIN,2161324006,870,127,997,761,76.33%
Colorado,2020,General,GRAND,2081325001,764,91,855,637,74.50%
Colorado,2020,General,GRAND,2081325002,1357,132,1489,1162,78.04%
Colorado,2020,General,GRAND,2081325003,1744,259,2003,1448,72.29%
Colorado,2020,General,GRAND,2081325004,858,77,935,695,74.33%
Colorado,2020,General,GRAND,2081325005,1098,129,1227,928,75.63%
Colorado,2020,General,GRAND,2081325006,768,128,896,661,73.77%
Colorado,2020,General,GRAND,2081325007,1106,185,1291,931,72.11%
Colorado,2020,General,GRAND,2081325008,769,93,862,670,77.73%
Colorado,2020,General,GRAND,2081325009,752,98,850,670,78.82%
Colorado,2020,General,GRAND,2081325010,850,104,954,731,76.62%
Colorado,2020,General,GRAND,2081325011,667,86,753,568,75.43%
Colorado,2020,General,GRAND,2081325012,972,111,1083,871,80.42%
Colorado,2020,General,GUNNISON,3055926008,866,114,980,781,79.69%
Colorado,2020,General,GUNNISON,3055926009,1010,163,1173,917,78.18%
Colorado,2020,General,GUNNISON,3055926010,597,287,884,508,57.47%
Colorado,2020,General,GUNNISON,3055926012,235,27,262,214,81.68%
Colorado,2020,General,GUNNISON,3055926013,1224,131,1355,1132,83.54%
Colorado,2020,General,GUNNISON,3055926014,1288,254,1542,1118,72.50%
Colorado,2020,General,GUNNISON,3055926015,556,144,700,486,69.43%
Colorado,2020,General,GUNNISON,3056126001,98,20,118,78,66.10%
Colorado,2020,General,GUNNISON,3056126002,326,30,356,287,80.62%
Colorado,2020,General,GUNNISON,3056126003,1432,165,1597,1313,82.22%
Colorado,2020,General,GUNNISON,3056126004,879,153,1032,779,75.48%
Colorado,2020,General,GUNNISON,3056126005,2040,175,2215,1871,84.47%
Colorado,2020,General,GUNNISON,3056126006,825,139,964,727,75.41%
Colorado,2020,General,GUNNISON,3056126007,811,87,898,758,84.41%
Colorado,2020,General,GUNNISON,3056126011,372,31,403,347,86.10%
Colorado,2020,General,HINSDALE,3055927001,700,93,793,640,80.71%
Colorado,2020,General,HUERFANO,3356228001,421,49,470,370,78.72%
Colorado,2020,General,HUERFANO,3356228002,788,82,870,707,81.26%
Colorado,2020,General,HUERFANO,3356228003,549,64,613,473,77.16%
Colorado,2020,General,HUERFANO,3356228004,774,80,854,625,73.19%
Colorado,2020,General,HUERFANO,3356228005,233,23,256,215,83.98%
Colorado,2020,General,HUERFANO,3356228006,643,86,729,526,72.15%
Colorado,2020,General,HUERFANO,3356228007,267,43,310,215,69.35%
Colorado,2020,General,HUERFANO,3356228008,117,17,134,101,75.37%
Colorado,2020,General,HUERFANO,3356228009,734,93,827,641,77.51%
Colorado,2020,General,HUERFANO,3356228010,488,61,549,439,79.96%
Colorado,2020,General,HUERFANO,3356228011,158,22,180,147,81.67%
Colorado,2020,General,JACKSON,3081329001,384,100,484,342,70.66%
Colorado,2020,General,JACKSON,3081329002,65,19,84,58,69.05%
Colorado,2020,General,JACKSON,3081329003,123,18,141,117,82.98%
Colorado,2020,General,JACKSON,3081329004,49,15,64,42,65.63%
Colorado,2020,General,JACKSON,3081329005,385,114,499,330,66.13%
Colorado,2020,General,JEFFERSON,1160130001,238,6,244,225,92.21%
Colorado,2020,General,JEFFERSON,1162230002,1327,134,1461,1176,80.49%
Colorado,2020,General,JEFFERSON,1162230003,1337,67,1404,1234,87.89%
Colorado,2020,General,JEFFERSON,1162230004,1780,99,1879,1589,84.57%
Colorado,2020,General,JEFFERSON,1162230005,1610,98,1708,1463,85.66%
Colorado,2020,General,JEFFERSON,1162230006,1694,89,1783,1584,88.84%
Colorado,2020,General,JEFFERSON,1162230007,1897,125,2022,1711,84.62%
Colorado,2020,General,JEFFERSON,1162230008,1702,133,1835,1509,82.23%
Colorado,2020,General,JEFFERSON,1162230009,1803,81,1884,1667,88.48%
Colorado,2020,General,JEFFERSON,1162230010,876,45,921,814,88.38%
Colorado,2020,General,JEFFERSON,1162230011,1193,45,1238,1086,87.72%
Colorado,2020,General,JEFFERSON,1162230012,1824,71,1895,1703,89.87%
Colorado,2020,General,JEFFERSON,1162230013,859,55,914,792,86.65%
Colorado,2020,General,JEFFERSON,1162230014,1306,67,1373,1197,87.18%
Colorado,2020,General,JEFFERSON,1202230015,452,52,504,396,78.57%
Colorado,2020,General,JEFFERSON,1222230016,1957,152,2109,1750,82.98%
Colorado,2020,General,JEFFERSON,1222230017,1091,112,1203,962,79.97%
Colorado,2020,General,JEFFERSON,1222230018,1814,105,1919,1700,88.59%
Colorado,2020,General,JEFFERSON,1222230019,1903,106,2009,1772,88.20%
Colorado,2020,General,JEFFERSON,1222230020,2025,74,2099,1841,87.71%
Colorado,2020,General,JEFFERSON,1222230021,1812,82,1894,1656,87.43%
Colorado,2020,General,JEFFERSON,1222230022,1254,67,1321,1149,86.98%
Colorado,2020,General,JEFFERSON,1222230023,1815,135,1950,1671,85.69%
Colorado,2020,General,JEFFERSON,1222230024,1759,96,1855,1631,87.92%
Colorado,2020,General,JEFFERSON,1222230025,1436,85,1521,1316,86.52%
Colorado,2020,General,JEFFERSON,1222230026,1091,54,1145,959,83.76%
Colorado,2020,General,JEFFERSON,1222230027,1590,69,1659,1487,89.63%
Colorado,2020,General,JEFFERSON,1222230028,1186,150,1336,1062,79.49%
Colorado,2020,General,JEFFERSON,1222230029,1662,131,1793,1543,86.06%
Colorado,2020,General,JEFFERSON,1222230030,2117,137,2254,1944,86.25%
Colorado,2020,General,JEFFERSON,1222230031,1382,89,1471,1222,83.07%
Colorado,2020,General,JEFFERSON,1222230032,1465,142,1607,1286,80.02%
Colorado,2020,General,JEFFERSON,1222230033,2016,128,2144,1803,84.10%
Colorado,2020,General,JEFFERSON,1222230034,1839,144,1983,1677,84.57%
Colorado,2020,General,JEFFERSON,1222230035,1207,80,1287,1096,85.16%
Colorado,2020,General,JEFFERSON,1222230285,860,53,913,779,85.32%
Colorado,2020,General,JEFFERSON,2162530036,1975,116,2091,1802,86.18%
Colorado,2020,General,JEFFERSON,2162530037,1186,83,1269,1097,86.45%
Colorado,2020,General,JEFFERSON,2162530038,1384,66,1450,1269,87.52%
Colorado,2020,General,JEFFERSON,2162530039,1442,85,1527,1312,85.92%
Colorado,2020,General,JEFFERSON,2162530040,1763,113,1876,1636,87.21%
Colorado,2020,General,JEFFERSON,2162530041,1050,62,1112,989,88.94%
Colorado,2020,General,JEFFERSON,2162530042,1273,82,1355,1156,85.31%
Colorado,2020,General,JEFFERSON,2162530043,924,47,971,849,87.44%
Colorado,2020,General,JEFFERSON,2162530044,1149,93,1242,1054,84.86%
Colorado,2020,General,JEFFERSON,2162530045,1217,67,1284,1137,88.55%
Colorado,2020,General,JEFFERSON,2162530046,1208,110,1318,1076,81.64%
Colorado,2020,General,JEFFERSON,2162530047,1262,88,1350,1172,86.81%
Colorado,2020,General,JEFFERSON,2162530048,1404,92,1496,1295,86.56%
Colorado,2020,General,JEFFERSON,2162530049,1273,97,1370,1170,85.40%
Colorado,2020,General,JEFFERSON,2162530050,1220,75,1295,1118,86.33%
Colorado,2020,General,JEFFERSON,2162530051,1546,135,1681,1418,84.35%
Colorado,2020,General,JEFFERSON,2162530052,1410,97,1507,1323,87.79%
Colorado,2020,General,JEFFERSON,2162530053,1057,55,1112,977,87.86%
Colorado,2020,General,JEFFERSON,2162530054,1351,83,1434,1265,88.21%
Colorado,2020,General,JEFFERSON,2162530055,650,54,704,593,84.23%
Colorado,2020,General,JEFFERSON,2162530056,1101,67,1168,1035,88.61%
Colorado,2020,General,JEFFERSON,2162530057,1365,121,1486,1244,83.71%
Colorado,2020,General,JEFFERSON,2162530058,1840,118,1958,1685,86.06%
Colorado,2020,General,JEFFERSON,2162530059,1373,116,1489,1244,83.55%
Colorado,2020,General,JEFFERSON,2162530060,649,68,717,568,79.22%
Colorado,2020,General,JEFFERSON,2162530061,1397,134,1531,1256,82.04%
Colorado,2020,General,JEFFERSON,2162530062,1493,112,1605,1379,85.92%
Colorado,2020,General,JEFFERSON,2162530063,1175,96,1271,1081,85.05%
Colorado,2020,General,JEFFERSON,2162530064,676,27,703,622,88.48%
Colorado,2020,General,JEFFERSON,2162530065,1580,124,1704,1465,85.97%
Colorado,2020,General,JEFFERSON,2162530066,1416,95,1511,1314,86.96%
Colorado,2020,General,JEFFERSON,2162530067,1312,116,1428,1203,84.24%
Colorado,2020,General,JEFFERSON,2162530068,1030,58,1088,947,87.04%
Colorado,2020,General,JEFFERSON,2202230069,660,46,706,590,83.57%
Colorado,2020,General,JEFFERSON,2202530070,1943,104,2047,1747,85.34%
Colorado,2020,General,JEFFERSON,2202530071,1775,97,1872,1603,85.63%
Colorado,2020,General,JEFFERSON,2202530072,1952,179,2131,1721,80.76%
Colorado,2020,General,JEFFERSON,2202530073,1288,68,1356,1168,86.14%
Colorado,2020,General,JEFFERSON,2202530074,1881,112,1993,1721,86.35%
Colorado,2020,General,JEFFERSON,2202530075,1968,192,2160,1781,82.45%
Colorado,2020,General,JEFFERSON,2202530076,1743,91,1834,1609,87.73%
Colorado,2020,General,JEFFERSON,2202530077,1695,64,1759,1625,92.38%
Colorado,2020,General,JEFFERSON,2202530078,1420,59,1479,1345,90.94%
Colorado,2020,General,JEFFERSON,2202530079,870,29,899,809,89.99%
Colorado,2020,General,JEFFERSON,2202530080,1257,47,1304,1172,89.88%
Colorado,2020,General,JEFFERSON,2202530284,744,67,811,671,82.74%
Colorado,2020,General,JEFFERSON,2222230081,1597,75,1672,1477,88.34%
Colorado,2020,General,JEFFERSON,2222230082,1425,45,1470,1305,88.78%
Colorado,2020,General,JEFFERSON,2222530083,929,37,966,873,90.37%
Colorado,2020,General,JEFFERSON,7162430084,1828,211,2039,1514,74.25%
Colorado,2020,General,JEFFERSON,7162430085,1912,291,2203,1605,72.86%
Colorado,2020,General,JEFFERSON,7162430086,1583,67,1650,1479,89.64%
Colorado,2020,General,JEFFERSON,7162430087,1011,80,1091,954,87.44%
Colorado,2020,General,JEFFERSON,7162430088,1893,271,2164,1625,75.09%
Colorado,2020,General,JEFFERSON,7162430089,1446,240,1686,1258,74.61%
Colorado,2020,General,JEFFERSON,7162430090,1317,339,1656,1155,69.75%
Colorado,2020,General,JEFFERSON,7162430091,1558,48,1606,1477,91.97%
Colorado,2020,General,JEFFERSON,7162430092,1248,63,1311,1181,90.08%
Colorado,2020,General,JEFFERSON,7162430093,1805,203,2008,1641,81.72%
Colorado,2020,General,JEFFERSON,7162430094,1333,193,1526,1219,79.88%
Colorado,2020,General,JEFFERSON,7162430095,1407,133,1540,1302,84.55%
Colorado,2020,General,JEFFERSON,7162530096,148,14,162,135,83.33%
Colorado,2020,General,JEFFERSON,7162530097,394,11,405,371,91.60%
Colorado,2020,General,JEFFERSON,7192430098,1041,46,1087,965,88.78%
Colorado,2020,General,JEFFERSON,7192730099,902,44,946,850,89.85%
Colorado,2020,General,JEFFERSON,7192730100,1216,39,1255,1153,91.87%
Colorado,2020,General,JEFFERSON,7192730101,1319,69,1388,1181,85.09%
Colorado,2020,General,JEFFERSON,7192730102,1409,63,1472,1266,86.01%
Colorado,2020,General,JEFFERSON,7192730103,1834,72,1906,1735,91.03%
Colorado,2020,General,JEFFERSON,7192730104,1340,93,1433,1191,83.11%
Colorado,2020,General,JEFFERSON,7192730105,1646,154,1800,1415,78.61%
Colorado,2020,General,JEFFERSON,7192730106,1020,75,1095,916,83.65%
Colorado,2020,General,JEFFERSON,7192730107,1801,102,1903,1671,87.81%
Colorado,2020,General,JEFFERSON,7192730108,1381,91,1472,1257,85.39%
Colorado,2020,General,JEFFERSON,7192730109,1528,105,1633,1372,84.02%
Colorado,2020,General,JEFFERSON,7192730110,1600,85,1685,1477,87.66%
Colorado,2020,General,JEFFERSON,7192730111,1337,135,1472,1167,79.28%
Colorado,2020,General,JEFFERSON,7192730112,1704,163,1867,1491,79.86%
Colorado,2020,General,JEFFERSON,7192730113,1708,58,1766,1620,91.73%
Colorado,2020,General,JEFFERSON,7192730114,1724,131,1855,1576,84.96%
Colorado,2020,General,JEFFERSON,7192730115,1913,109,2022,1774,87.73%
Colorado,2020,General,JEFFERSON,7192730116,1617,52,1669,1521,91.13%
Colorado,2020,General,JEFFERSON,7192730117,1757,89,1846,1617,87.59%
Colorado,2020,General,JEFFERSON,7192730118,1791,72,1863,1657,88.94%
Colorado,2020,General,JEFFERSON,7192730119,1353,155,1508,1108,73.47%
Colorado,2020,General,JEFFERSON,7192730120,1593,252,1845,1372,74.36%
Colorado,2020,General,JEFFERSON,7192730121,1786,173,1959,1568,80.04%
Colorado,2020,General,JEFFERSON,7192730122,1236,106,1342,1069,79.66%
Colorado,2020,General,JEFFERSON,7192730123,1892,138,2030,1672,82.36%
Colorado,2020,General,JEFFERSON,7192730124,1019,147,1166,873,74.87%
Colorado,2020,General,JEFFERSON,7192730125,1515,199,1714,1263,73.69%
Colorado,2020,General,JEFFERSON,7192730126,1307,83,1390,1215,87.41%
Colorado,2020,General,JEFFERSON,7192730263,785,32,817,695,85.07%
Colorado,2020,General,JEFFERSON,7192730264,1182,74,1256,1130,89.97%
Colorado,2020,General,JEFFERSON,7192730265,752,28,780,696,89.23%
Colorado,2020,General,JEFFERSON,7192730269,816,82,898,739,82.29%
Colorado,2020,General,JEFFERSON,7192730270,960,108,1068,813,76.12%
Colorado,2020,General,JEFFERSON,7192730291,846,85,931,778,83.57%
Colorado,2020,General,JEFFERSON,7192730292,1266,141,1407,1144,81.31%
Colorado,2020,General,JEFFERSON,7192730293,962,99,1061,801,75.49%
Colorado,2020,General,JEFFERSON,7192730294,997,48,1045,911,87.18%
Colorado,2020,General,JEFFERSON,7192730308,981,63,1044,902,86.40%
Colorado,2020,General,JEFFERSON,7192930127,1843,95,1938,1669,86.12%
Colorado,2020,General,JEFFERSON,7192930128,1198,154,1352,1071,79.22%
Colorado,2020,General,JEFFERSON,7192930129,1373,111,1484,1210,81.54%
Colorado,2020,General,JEFFERSON,7192930130,1389,110,1499,1235,82.39%
Colorado,2020,General,JEFFERSON,7192930131,1470,115,1585,1323,83.47%
Colorado,2020,General,JEFFERSON,7192930132,1389,66,1455,1268,87.15%
Colorado,2020,General,JEFFERSON,7192930133,915,80,995,821,82.51%
Colorado,2020,General,JEFFERSON,7192930134,1409,134,1543,1279,82.89%
Colorado,2020,General,JEFFERSON,7192930135,1003,62,1065,926,86.95%
Colorado,2020,General,JEFFERSON,7192930136,1784,106,1890,1636,86.56%
Colorado,2020,General,JEFFERSON,7192930137,1901,123,2024,1700,83.99%
Colorado,2020,General,JEFFERSON,7192930138,1481,82,1563,1344,85.99%
Colorado,2020,General,JEFFERSON,7192930139,2054,138,2192,1802,82.21%
Colorado,2020,General,JEFFERSON,7192930140,1564,96,1660,1413,85.12%
Colorado,2020,General,JEFFERSON,7192930141,1143,91,1234,1038,84.12%
Colorado,2020,General,JEFFERSON,7192930142,1548,139,1687,1411,83.64%
Colorado,2020,General,JEFFERSON,7192930143,1716,97,1813,1565,86.32%
Colorado,2020,General,JEFFERSON,7192930144,1462,87,1549,1293,83.47%
Colorado,2020,General,JEFFERSON,7192930145,1472,119,1591,1261,79.26%
Colorado,2020,General,JEFFERSON,7192930146,1722,221,1943,1448,74.52%
Colorado,2020,General,JEFFERSON,7192930147,1271,93,1364,1082,79.33%
Colorado,2020,General,JEFFERSON,7192930148,1013,84,1097,897,81.77%
Colorado,2020,General,JEFFERSON,7192930149,1930,110,2040,1683,82.50%
Colorado,2020,General,JEFFERSON,7192930150,1531,82,1613,1366,84.69%
Colorado,2020,General,JEFFERSON,7192930151,872,66,938,743,79.21%
Colorado,2020,General,JEFFERSON,7192930152,1673,79,1752,1554,88.70%
Colorado,2020,General,JEFFERSON,7192930153,1245,104,1349,1097,81.32%
Colorado,2020,General,JEFFERSON,7192930154,1955,152,2107,1680,79.73%
Colorado,2020,General,JEFFERSON,7192930155,1863,115,1978,1645,83.16%
Colorado,2020,General,JEFFERSON,7192930156,1756,117,1873,1559,83.24%
Colorado,2020,General,JEFFERSON,7192930157,1675,154,1829,1438,78.62%
Colorado,2020,General,JEFFERSON,7192930259,884,58,942,799,84.82%
Colorado,2020,General,JEFFERSON,7192930260,1537,121,1658,1322,79.73%
Colorado,2020,General,JEFFERSON,7192930261,767,53,820,674,82.20%
Colorado,2020,General,JEFFERSON,7192930262,798,107,905,653,72.15%
Colorado,2020,General,JEFFERSON,7192930266,1179,72,1251,1003,80.18%
Colorado,2020,General,JEFFERSON,7192930267,1027,76,1103,880,79.78%
Colorado,2020,General,JEFFERSON,7192930268,1219,112,1331,964,72.43%
Colorado,2020,General,JEFFERSON,7192930298,1374,281,1655,1117,67.49%
Colorado,2020,General,JEFFERSON,7192930299,912,89,1001,785,78.42%
Colorado,2020,General,JEFFERSON,7202330158,1835,233,2068,1582,76.50%
Colorado,2020,General,JEFFERSON,7202330159,1299,123,1422,1122,78.90%
Colorado,2020,General,JEFFERSON,7202330160,1191,82,1273,994,78.08%
Colorado,2020,General,JEFFERSON,7202330161,1146,115,1261,972,77.08%
Colorado,2020,General,JEFFERSON,7202330162,1535,119,1654,1350,81.62%
Colorado,2020,General,JEFFERSON,7202330163,953,134,1087,821,75.53%
Colorado,2020,General,JEFFERSON,7202330164,1808,80,1888,1678,88.88%
Colorado,2020,General,JEFFERSON,7202330165,1854,111,1965,1733,88.19%
Colorado,2020,General,JEFFERSON,7202330166,1852,138,1990,1701,85.48%
Colorado,2020,General,JEFFERSON,7202330167,1162,222,1384,1007,72.76%
Colorado,2020,General,JEFFERSON,7202330168,1051,70,1121,961,85.73%
Colorado,2020,General,JEFFERSON,7202330169,1464,54,1518,1364,89.86%
Colorado,2020,General,JEFFERSON,7202330170,1610,83,1693,1494,88.25%
Colorado,2020,General,JEFFERSON,7202330171,1117,80,1197,1037,86.63%
Colorado,2020,General,JEFFERSON,7202330172,1962,177,2139,1715,80.18%
Colorado,2020,General,JEFFERSON,7202330173,2110,368,2478,1761,71.07%
Colorado,2020,General,JEFFERSON,7202330174,1924,117,2041,1702,83.39%
Colorado,2020,General,JEFFERSON,7202330175,1030,61,1091,905,82.95%
Colorado,2020,General,JEFFERSON,7202330176,1473,53,1526,1377,90.24%
Colorado,2020,General,JEFFERSON,7202330177,1056,60,1116,979,87.72%
Colorado,2020,General,JEFFERSON,7202330178,1062,175,1237,890,71.95%
Colorado,2020,General,JEFFERSON,7202330179,1929,166,2095,1746,83.34%
Colorado,2020,General,JEFFERSON,7202330180,1566,199,1765,1354,76.71%
Colorado,2020,General,JEFFERSON,7202330181,1688,110,1798,1501,83.48%
Colorado,2020,General,JEFFERSON,7202330275,877,122,999,662,66.27%
Colorado,2020,General,JEFFERSON,7202330287,934,89,1023,786,76.83%
Colorado,2020,General,JEFFERSON,7202330288,1141,58,1199,1038,86.57%
Colorado,2020,General,JEFFERSON,7202330301,567,82,649,489,75.35%
Colorado,2020,General,JEFFERSON,7202330302,681,172,853,511,59.91%
Colorado,2020,General,JEFFERSON,7202330307,983,106,1089,836,76.77%
Colorado,2020,General,JEFFERSON,7202330309,785,34,819,732,89.38%
Colorado,2020,General,JEFFERSON,7202430182,950,33,983,882,89.73%
Colorado,2020,General,JEFFERSON,7202430183,1451,54,1505,1354,89.97%
Colorado,2020,General,JEFFERSON,7202430184,869,46,915,813,88.85%
Colorado,2020,General,JEFFERSON,7202430185,1583,102,1685,1428,84.75%
Colorado,2020,General,JEFFERSON,7202430186,1838,193,2031,1674,82.42%
Colorado,2020,General,JEFFERSON,7202430187,1314,63,1377,1233,89.54%
Colorado,2020,General,JEFFERSON,7202430188,1540,131,1671,1327,79.41%
Colorado,2020,General,JEFFERSON,7202430189,1142,86,1228,1030,83.88%
Colorado,2020,General,JEFFERSON,7202430190,1222,85,1307,1074,82.17%
Colorado,2020,General,JEFFERSON,7202430191,2117,161,2278,1865,81.87%
Colorado,2020,General,JEFFERSON,7202430192,1758,105,1863,1553,83.36%
Colorado,2020,General,JEFFERSON,7202430193,1575,91,1666,1436,86.19%
Colorado,2020,General,JEFFERSON,7202430194,1208,143,1351,1040,76.98%
Colorado,2020,General,JEFFERSON,7202430195,1133,114,1247,927,74.34%
Colorado,2020,General,JEFFERSON,7202430196,1576,100,1676,1428,85.20%
Colorado,2020,General,JEFFERSON,7202430197,1253,102,1355,1092,80.59%
Colorado,2020,General,JEFFERSON,7202430198,1302,269,1571,1059,67.41%
Colorado,2020,General,JEFFERSON,7202430199,1331,59,1390,1217,87.55%
Colorado,2020,General,JEFFERSON,7202430200,1429,122,1551,1258,81.11%
Colorado,2020,General,JEFFERSON,7202430201,1820,104,1924,1641,85.29%
Colorado,2020,General,JEFFERSON,7202430271,612,54,666,523,78.53%
Colorado,2020,General,JEFFERSON,7202430272,1014,192,1206,796,66.00%
Colorado,2020,General,JEFFERSON,7202430273,1059,111,1170,913,78.03%
Colorado,2020,General,JEFFERSON,7202430274,1071,97,1168,921,78.85%
Colorado,2020,General,JEFFERSON,7202430289,1052,77,1129,932,82.55%
Colorado,2020,General,JEFFERSON,7202430300,1152,37,1189,1082,91.00%
Colorado,2020,General,JEFFERSON,7202430305,838,36,874,765,87.53%
Colorado,2020,General,JEFFERSON,7202530202,1328,49,1377,1268,92.08%
Colorado,2020,General,JEFFERSON,7202530203,575,48,623,516,82.83%
Colorado,2020,General,JEFFERSON,7202530204,1564,98,1662,1413,85.02%
Colorado,2020,General,JEFFERSON,7202730205,1789,67,1856,1682,90.63%
Colorado,2020,General,JEFFERSON,7202730206,1418,57,1475,1318,89.36%
Colorado,2020,General,JEFFERSON,7202730207,1812,74,1886,1721,91.25%
Colorado,2020,General,JEFFERSON,7202730208,1827,72,1899,1736,91.42%
Colorado,2020,General,JEFFERSON,7202730209,1744,101,1845,1614,87.48%
Colorado,2020,General,JEFFERSON,7202730210,1327,65,1392,1251,89.87%
Colorado,2020,General,JEFFERSON,7202730211,1796,68,1864,1689,90.61%
Colorado,2020,General,JEFFERSON,7202730290,1343,70,1413,1269,89.81%
Colorado,2020,General,JEFFERSON,7202730295,1502,35,1537,1423,92.58%
Colorado,2020,General,JEFFERSON,7202730296,1893,67,1960,1773,90.46%
Colorado,2020,General,JEFFERSON,7202730297,1497,69,1566,1400,89.40%
Colorado,2020,General,JEFFERSON,7202830212,1608,62,1670,1505,90.12%
Colorado,2020,General,JEFFERSON,7202830213,1414,50,1464,1300,88.80%
Colorado,2020,General,JEFFERSON,7202830214,1948,84,2032,1808,88.98%
Colorado,2020,General,JEFFERSON,7202830215,1347,39,1386,1272,91.77%
Colorado,2020,General,JEFFERSON,7202830216,1781,239,2020,1529,75.69%
Colorado,2020,General,JEFFERSON,7202830217,1319,142,1461,1162,79.53%
Colorado,2020,General,JEFFERSON,7202830286,1303,57,1360,1232,90.59%
Colorado,2020,General,JEFFERSON,7222230218,1139,50,1189,1057,88.90%
Colorado,2020,General,JEFFERSON,7222230219,946,52,998,864,86.57%
Colorado,2020,General,JEFFERSON,7222230283,1027,49,1076,939,87.27%
Colorado,2020,General,JEFFERSON,7222330220,1297,203,1500,1099,73.27%
Colorado,2020,General,JEFFERSON,7222330221,1012,46,1058,943,89.13%
Colorado,2020,General,JEFFERSON,7222330222,1430,246,1676,1136,67.78%
Colorado,2020,General,JEFFERSON,7222330223,1637,80,1717,1474,85.85%
Colorado,2020,General,JEFFERSON,7222330224,1760,322,2082,1371,65.85%
Colorado,2020,General,JEFFERSON,7222330225,1395,230,1625,1129,69.48%
Colorado,2020,General,JEFFERSON,7222330226,1512,214,1726,1221,70.74%
Colorado,2020,General,JEFFERSON,7222330227,1220,226,1446,984,68.05%
Colorado,2020,General,JEFFERSON,7222330228,1074,39,1113,984,88.41%
Colorado,2020,General,JEFFERSON,7222330229,1842,230,2072,1620,78.19%
Colorado,2020,General,JEFFERSON,7222330276,997,117,1114,810,72.71%
Colorado,2020,General,JEFFERSON,7222330277,1232,183,1415,954,67.42%
Colorado,2020,General,JEFFERSON,7222330279,1073,57,1130,966,85.49%
Colorado,2020,General,JEFFERSON,7222330304,878,57,935,810,86.63%
Colorado,2020,General,JEFFERSON,7222430230,1442,161,1603,1278,79.73%
Colorado,2020,General,JEFFERSON,7222430231,1736,247,1983,1476,74.43%
Colorado,2020,General,JEFFERSON,7222830232,1098,134,1232,964,78.25%
Colorado,2020,General,JEFFERSON,7222830233,1046,42,1088,944,86.76%
Colorado,2020,General,JEFFERSON,7222830234,1331,87,1418,1169,82.44%
Colorado,2020,General,JEFFERSON,7222830235,1650,82,1732,1514,87.41%
Colorado,2020,General,JEFFERSON,7222830236,1570,74,1644,1446,87.96%
Colorado,2020,General,JEFFERSON,7222830237,1491,208,1699,1284,75.57%
Colorado,2020,General,JEFFERSON,7222830238,1715,240,1955,1459,74.63%
Colorado,2020,General,JEFFERSON,7222830239,1439,151,1590,1247,78.43%
Colorado,2020,General,JEFFERSON,7222830240,1760,177,1937,1536,79.30%
Colorado,2020,General,JEFFERSON,7222830241,1617,184,1801,1253,69.57%
Colorado,2020,General,JEFFERSON,7222830242,1535,133,1668,1271,76.20%
Colorado,2020,General,JEFFERSON,7222830243,1475,78,1553,1320,85.00%
Colorado,2020,General,JEFFERSON,7222830244,1482,98,1580,1273,80.57%
Colorado,2020,General,JEFFERSON,7222830245,2001,136,2137,1685,78.85%
Colorado,2020,General,JEFFERSON,7222830246,1080,48,1128,987,87.50%
Colorado,2020,General,JEFFERSON,7222830247,1082,120,1202,890,74.04%
Colorado,2020,General,JEFFERSON,7222830248,1556,180,1736,1262,72.70%
Colorado,2020,General,JEFFERSON,7222830249,1277,334,1611,1076,66.79%
Colorado,2020,General,JEFFERSON,7222830250,1472,121,1593,1305,81.92%
Colorado,2020,General,JEFFERSON,7222830251,1109,176,1285,954,74.24%
Colorado,2020,General,JEFFERSON,7222830252,1991,98,2089,1762,84.35%
Colorado,2020,General,JEFFERSON,7222830253,1233,156,1389,1052,75.74%
Colorado,2020,General,JEFFERSON,7222830254,1801,123,1924,1617,84.04%
Colorado,2020,General,JEFFERSON,7222830255,1548,125,1673,1302,77.82%
Colorado,2020,General,JEFFERSON,7222830256,1093,83,1176,964,81.97%
Colorado,2020,General,JEFFERSON,7222830257,1961,185,2146,1747,81.41%
Colorado,2020,General,JEFFERSON,7222830258,1665,134,1799,1471,81.77%
Colorado,2020,General,JEFFERSON,7222830278,1144,123,1267,906,71.51%
Colorado,2020,General,JEFFERSON,7222830280,1021,71,1092,873,79.95%
Colorado,2020,General,JEFFERSON,7222830281,791,61,852,704,82.63%
Colorado,2020,General,JEFFERSON,7222830282,1255,129,1384,1013,73.19%
Colorado,2020,General,JEFFERSON,7222830303,698,59,757,564,74.50%
Colorado,2020,General,JEFFERSON,7222830306,853,162,1015,761,74.98%
Colorado,2020,General,KIOWA,4356431001,214,17,231,179,77.49%
Colorado,2020,General,KIOWA,4356431002,296,28,324,270,83.33%
Colorado,2020,General,KIOWA,4356431003,401,27,428,369,86.21%
Colorado,2020,General,KIOWA,4356431004,93,4,97,91,93.81%
Colorado,2020,General,KIT CARSON,4016532001,447,53,500,365,73.00%
Colorado,2020,General,KIT CARSON,4016532002,328,54,382,264,69.11%
Colorado,2020,General,KIT CARSON,4016532003,461,82,543,383,70.53%
Colorado,2020,General,KIT CARSON,4016532004,366,37,403,327,81.14%
Colorado,2020,General,KIT CARSON,4016532005,552,57,609,462,75.86%
Colorado,2020,General,KIT CARSON,4016532006,376,39,415,320,77.11%
Colorado,2020,General,KIT CARSON,4016532007,345,25,370,307,82.97%
Colorado,2020,General,KIT CARSON,4016532008,281,32,313,248,79.23%
Colorado,2020,General,KIT CARSON,4016532009,405,38,443,342,77.20%
Colorado,2020,General,KIT CARSON,4016532010,185,19,204,163,79.90%
Colorado,2020,General,KIT CARSON,4016532011,250,26,276,216,78.26%
Colorado,2020,General,KIT CARSON,4016532012,256,21,277,215,77.62%
Colorado,2020,General,KIT CARSON,4016532013,324,28,352,281,79.83%
Colorado,2020,General,LA PLATA,3065934001,1086,253,1339,862,64.38%
Colorado,2020,General,LA PLATA,3065934002,1211,268,1479,1040,70.32%
Colorado,2020,General,LA PLATA,3065934003,1462,183,1645,1285,78.12%
Colorado,2020,General,LA PLATA,3065934004,1661,271,1932,1478,76.50%
Colorado,2020,General,LA PLATA,3065934005,1516,227,1743,1340,76.88%
Colorado,2020,General,LA PLATA,3065934006,595,72,667,538,80.66%
Colorado,2020,General,LA PLATA,3065934007,1440,347,1787,1203,67.32%
Colorado,2020,General,LA PLATA,3065934008,1706,336,2042,1444,70.71%
Colorado,2020,General,LA PLATA,3065934009,441,160,601,305,50.75%
Colorado,2020,General,LA PLATA,3065934010,952,128,1080,885,81.94%
Colorado,2020,General,LA PLATA,3065934011,1624,226,1850,1421,76.81%
Colorado,2020,General,LA PLATA,3065934012,1746,251,1997,1516,75.91%
Colorado,2020,General,LA PLATA,3065934013,1554,251,1805,1342,74.35%
Colorado,2020,General,LA PLATA,3065934014,1259,145,1404,1143,81.41%
Colorado,2020,General,LA PLATA,3065934015,839,169,1008,731,72.52%
Colorado,2020,General,LA PLATA,3065934016,1609,233,1842,1397,75.84%
Colorado,2020,General,LA PLATA,3065934017,1602,278,1880,1398,74.36%
Colorado,2020,General,LA PLATA,3065934018,1072,118,1190,926,77.82%
Colorado,2020,General,LA PLATA,3065934019,1553,168,1721,1371,79.66%
Colorado,2020,General,LA PLATA,3065934020,1858,338,2196,1588,72.31%
Colorado,2020,General,LA PLATA,3065934021,1164,172,1336,981,73.43%
Colorado,2020,General,LA PLATA,3065934022,1258,166,1424,1114,78.23%
Colorado,2020,General,LA PLATA,3065934023,1499,186,1685,1228,72.88%
Colorado,2020,General,LA PLATA,3065934024,498,77,575,399,69.39%
Colorado,2020,General,LA PLATA,3065934025,1312,153,1465,1052,71.81%
Colorado,2020,General,LA PLATA,3065934026,1313,225,1538,1137,73.93%
Colorado,2020,General,LA PLATA,3065934027,357,71,428,318,74.30%
Colorado,2020,General,LA PLATA,3065934028,1556,218,1774,1381,77.85%
Colorado,2020,General,LA PLATA,3065934029,1648,199,1847,1476,79.91%
Colorado,2020,General,LA PLATA,3065934030,1785,814,2599,1510,58.10%
Colorado,2020,General,LA PLATA,3065934031,800,143,943,676,71.69%
Colorado,2020,General,LA PLATA,3065934032,1715,204,1919,1500,78.17%
Colorado,2020,General,LAKE,3056133001,826,167,993,697,70.19%
Colorado,2020,General,LAKE,3056133002,512,149,661,417,63.09%
Colorado,2020,General,LAKE,3056133003,951,222,1173,780,66.50%
Colorado,2020,General,LAKE,3056133004,968,167,1135,811,71.45%
Colorado,2020,General,LAKE,3056133005,726,171,897,613,68.34%
Colorado,2020,General,LAKE,3056133006,846,214,1060,692,65.28%
Colorado,2020,General,LARIMER,2145235201,1106,264,1370,817,59.64%
Colorado,2020,General,LARIMER,2145235202,1505,164,1669,1295,77.59%
Colorado,2020,General,LARIMER,2145235203,1415,138,1553,1272,81.91%
Colorado,2020,General,LARIMER,2145235204,1717,201,1918,1481,77.22%
Colorado,2020,General,LARIMER,2145235205,1353,310,1663,1205,72.46%
Colorado,2020,General,LARIMER,2145235206,1681,263,1944,1502,77.26%
Colorado,2020,General,LARIMER,2145235207,1176,228,1404,1032,73.50%
Colorado,2020,General,LARIMER,2145235208,1465,253,1718,1317,76.66%
Colorado,2020,General,LARIMER,2145235209,1427,162,1589,1300,81.81%
Colorado,2020,General,LARIMER,2145235210,1404,241,1645,1220,74.16%
Colorado,2020,General,LARIMER,2145235211,1378,239,1617,1232,76.19%
Colorado,2020,General,LARIMER,2145235212,1125,78,1203,1041,86.53%
Colorado,2020,General,LARIMER,2145235213,1053,167,1220,935,76.64%
Colorado,2020,General,LARIMER,2145235214,1411,149,1560,1278,81.92%
Colorado,2020,General,LARIMER,2145235215,1119,121,1240,969,78.15%
Colorado,2020,General,LARIMER,2145235216,966,158,1124,834,74.20%
Colorado,2020,General,LARIMER,2145235217,1502,137,1639,1370,83.59%
Colorado,2020,General,LARIMER,2145235218,1443,206,1649,1311,79.50%
Colorado,2020,General,LARIMER,2145235219,1580,127,1707,1485,86.99%
Colorado,2020,General,LARIMER,2145235220,1288,92,1380,1193,86.45%
Colorado,2020,General,LARIMER,2145235221,999,94,1093,860,78.68%
Colorado,2020,General,LARIMER,2145235222,792,53,845,748,88.52%
Colorado,2020,General,LARIMER,2145235223,1473,155,1628,1351,82.99%
Colorado,2020,General,LARIMER,2145235224,1123,89,1212,999,82.43%
Colorado,2020,General,LARIMER,2145235225,1620,51,1671,1516,90.72%
Colorado,2020,General,LARIMER,2145235226,1313,130,1443,1079,74.77%
Colorado,2020,General,LARIMER,2145235227,1039,79,1118,964,86.23%
Colorado,2020,General,LARIMER,2145235228,1368,109,1477,1274,86.26%
Colorado,2020,General,LARIMER,2145235229,1701,157,1858,1541,82.94%
Colorado,2020,General,LARIMER,2145235230,1357,79,1436,1253,87.26%
Colorado,2020,General,LARIMER,2145235231,1192,137,1329,1061,79.83%
Colorado,2020,General,LARIMER,2145235232,1172,71,1243,1098,88.33%
Colorado,2020,General,LARIMER,2145235233,1342,80,1422,1230,86.50%
Colorado,2020,General,LARIMER,2145235234,1495,127,1622,1360,83.85%
Colorado,2020,General,LARIMER,2145235235,1058,64,1122,966,86.10%
Colorado,2020,General,LARIMER,2145235236,955,42,997,899,90.17%
Colorado,2020,General,LARIMER,2145235237,1392,104,1496,1279,85.49%
Colorado,2020,General,LARIMER,2145235238,1122,84,1206,1035,85.82%
Colorado,2020,General,LARIMER,2145235239,650,87,737,477,64.72%
Colorado,2020,General,LARIMER,2145235240,996,109,1105,852,77.10%
Colorado,2020,General,LARIMER,2145235241,1217,121,1338,1134,84.75%
Colorado,2020,General,LARIMER,2145235242,1621,201,1822,1387,76.13%
Colorado,2020,General,LARIMER,2145235243,1059,51,1110,995,89.64%
Colorado,2020,General,LARIMER,2145235244,833,109,942,761,80.79%
Colorado,2020,General,LARIMER,2145235245,949,110,1059,852,80.45%
Colorado,2020,General,LARIMER,2145235246,1112,207,1319,941,71.34%
Colorado,2020,General,LARIMER,2145235247,720,134,854,599,70.14%
Colorado,2020,General,LARIMER,2145235248,926,158,1084,809,74.63%
Colorado,2020,General,LARIMER,2145235249,1260,75,1335,1184,88.69%
Colorado,2020,General,LARIMER,2145235250,697,73,770,616,80.00%
Colorado,2020,General,LARIMER,2145235251,945,44,989,791,79.98%
Colorado,2020,General,LARIMER,2145235252,889,94,983,806,81.99%
Colorado,2020,General,LARIMER,2145335301,1157,190,1347,1008,74.83%
Colorado,2020,General,LARIMER,2145335302,1730,185,1915,1570,81.98%
Colorado,2020,General,LARIMER,2145335303,1373,166,1539,1231,79.99%
Colorado,2020,General,LARIMER,2145335304,976,205,1181,822,69.60%
Colorado,2020,General,LARIMER,2145335305,1554,282,1836,1370,74.62%
Colorado,2020,General,LARIMER,2145335306,812,223,1035,651,62.90%
Colorado,2020,General,LARIMER,2145335307,733,259,992,621,62.60%
Colorado,2020,General,LARIMER,2145335308,1001,339,1340,798,59.55%
Colorado,2020,General,LARIMER,2145335309,446,543,989,364,36.80%
Colorado,2020,General,LARIMER,2145335310,992,137,1129,888,78.65%
Colorado,2020,General,LARIMER,2145335311,876,171,1047,772,73.73%
Colorado,2020,General,LARIMER,2145335312,1505,293,1798,1275,70.91%
Colorado,2020,General,LARIMER,2145335313,1402,152,1554,1257,80.89%
Colorado,2020,General,LARIMER,2145335314,1188,121,1309,1091,83.35%
Colorado,2020,General,LARIMER,2145335315,1504,159,1663,1344,80.82%
Colorado,2020,General,LARIMER,2145335316,1029,81,1110,924,83.24%
Colorado,2020,General,LARIMER,2145335317,1458,61,1519,1359,89.47%
Colorado,2020,General,LARIMER,2145335318,1447,239,1686,1256,74.50%
Colorado,2020,General,LARIMER,2145335319,1280,121,1401,1153,82.30%
Colorado,2020,General,LARIMER,2145335320,1129,151,1280,993,77.58%
Colorado,2020,General,LARIMER,2145335321,1413,258,1671,1223,73.19%
Colorado,2020,General,LARIMER,2145335322,1543,138,1681,1357,80.73%
Colorado,2020,General,LARIMER,2145335323,1459,131,1590,1325,83.33%
Colorado,2020,General,LARIMER,2145335324,1672,77,1749,1571,89.82%
Colorado,2020,General,LARIMER,2145335325,1706,174,1880,1506,80.11%
Colorado,2020,General,LARIMER,2145335326,1007,102,1109,875,78.90%
Colorado,2020,General,LARIMER,2145335327,1480,91,1571,1348,85.81%
Colorado,2020,General,LARIMER,2145335328,1534,68,1602,1420,88.64%
Colorado,2020,General,LARIMER,2145335329,1291,84,1375,1190,86.55%
Colorado,2020,General,LARIMER,2145335330,1397,88,1485,1291,86.94%
Colorado,2020,General,LARIMER,2145335331,950,83,1033,865,83.74%
Colorado,2020,General,LARIMER,2145335332,1233,108,1341,1042,77.70%
Colorado,2020,General,LARIMER,2145335333,1030,81,1111,929,83.62%
Colorado,2020,General,LARIMER,2145335334,1014,412,1426,821,57.57%
Colorado,2020,General,LARIMER,2145335335,263,278,541,225,41.59%
Colorado,2020,General,LARIMER,2145335336,994,282,1276,847,66.38%
Colorado,2020,General,LARIMER,2145335337,1208,216,1424,1003,70.44%
Colorado,2020,General,LARIMER,2145335338,796,377,1173,673,57.37%
Colorado,2020,General,LARIMER,2145335339,936,165,1101,784,71.21%
Colorado,2020,General,LARIMER,2145335340,918,112,1030,819,79.51%
Colorado,2020,General,LARIMER,2145335341,755,180,935,656,70.16%
Colorado,2020,General,LARIMER,2145335342,814,101,915,725,79.23%
Colorado,2020,General,LARIMER,2145335343,929,197,1126,784,69.63%
Colorado,2020,General,LARIMER,2145335344,886,167,1053,751,71.32%
Colorado,2020,General,LARIMER,2154935401,787,84,871,682,78.30%
Colorado,2020,General,LARIMER,2154935402,895,75,970,803,82.78%
Colorado,2020,General,LARIMER,2154935403,1421,103,1524,1254,82.28%
Colorado,2020,General,LARIMER,2154935404,114,17,131,91,69.47%
Colorado,2020,General,LARIMER,2154935405,801,52,853,724,84.88%
Colorado,2020,General,LARIMER,2154935406,924,65,989,857,86.65%
Colorado,2020,General,LARIMER,2154935407,842,75,917,761,82.99%
Colorado,2020,General,LARIMER,2154935408,943,75,1018,841,82.61%
Colorado,2020,General,LARIMER,2154935409,1304,92,1396,1180,84.53%
Colorado,2020,General,LARIMER,2154935410,1147,96,1243,996,80.13%
Colorado,2020,General,LARIMER,2154935411,1502,145,1647,1361,82.64%
Colorado,2020,General,LARIMER,2154935412,922,119,1041,804,77.23%
Colorado,2020,General,LARIMER,2154935413,1338,161,1499,1219,81.32%
Colorado,2020,General,LARIMER,2154935414,1237,126,1363,1101,80.78%
Colorado,2020,General,LARIMER,2154935415,1414,183,1597,1214,76.02%
Colorado,2020,General,LARIMER,2154935416,1393,114,1507,1280,84.94%
Colorado,2020,General,LARIMER,2154935417,1248,62,1310,1141,87.10%
Colorado,2020,General,LARIMER,2154935418,1710,93,1803,1580,87.63%
Colorado,2020,General,LARIMER,2154935419,1163,29,1192,1054,88.42%
Colorado,2020,General,LARIMER,2154935420,1132,102,1234,1016,82.33%
Colorado,2020,General,LARIMER,2154935421,1095,73,1168,983,84.16%
Colorado,2020,General,LARIMER,2154935422,1193,40,1233,1106,89.70%
Colorado,2020,General,LARIMER,2154935423,1592,72,1664,1490,89.54%
Colorado,2020,General,LARIMER,2154935424,48,1,49,43,87.76%
Colorado,2020,General,LARIMER,2154935425,178,11,189,159,84.13%
Colorado,2020,General,LARIMER,2154935426,1158,44,1202,1046,87.02%
Colorado,2020,General,LARIMER,2154935427,1388,74,1462,1294,88.51%
Colorado,2020,General,LARIMER,2154935428,1326,88,1414,1221,86.35%
Colorado,2020,General,LARIMER,2154935429,1069,88,1157,955,82.54%
Colorado,2020,General,LARIMER,2154935430,1040,63,1103,942,85.40%
Colorado,2020,General,LARIMER,2154935431,1593,120,1713,1410,82.31%
Colorado,2020,General,LARIMER,2154935432,1841,193,2034,1625,79.89%
Colorado,2020,General,LARIMER,2154935433,1588,187,1775,1386,78.08%
Colorado,2020,General,LARIMER,2154935434,1503,97,1600,1326,82.88%
Colorado,2020,General,LARIMER,2154935435,1305,107,1412,1182,83.71%
Colorado,2020,General,LARIMER,2154935436,1050,72,1122,951,84.76%
Colorado,2020,General,LARIMER,2154935437,1049,59,1108,967,87.27%
Colorado,2020,General,LARIMER,2154935438,1100,95,1195,993,83.10%
Colorado,2020,General,LARIMER,2154935439,762,79,841,668,79.43%
Colorado,2020,General,LARIMER,2154935440,1023,75,1098,900,81.97%
Colorado,2020,General,LARIMER,2154935441,955,57,1012,893,88.24%
Colorado,2020,General,LARIMER,2154935442,1551,79,1630,1381,84.72%
Colorado,2020,General,LARIMER,2154935443,760,71,831,655,78.82%
Colorado,2020,General,LARIMER,2154935444,834,49,883,754,85.39%
Colorado,2020,General,LARIMER,2155135501,1265,125,1390,1109,79.78%
Colorado,2020,General,LARIMER,2155135502,1331,80,1411,1217,86.25%
Colorado,2020,General,LARIMER,2155135503,1579,139,1718,1395,81.20%
Colorado,2020,General,LARIMER,2155135504,1544,118,1662,1321,79.48%
Colorado,2020,General,LARIMER,2155135505,1389,170,1559,1172,75.18%
Colorado,2020,General,LARIMER,2155135506,1256,128,1384,1072,77.46%
Colorado,2020,General,LARIMER,2155135507,1753,89,1842,1629,88.44%
Colorado,2020,General,LARIMER,2155135508,1101,104,1205,1021,84.73%
Colorado,2020,General,LARIMER,2155135509,929,94,1023,817,79.86%
Colorado,2020,General,LARIMER,2155135510,1453,108,1561,1313,84.11%
Colorado,2020,General,LARIMER,2155135511,915,56,971,838,86.30%
Colorado,2020,General,LARIMER,2155135512,1549,148,1697,1398,82.38%
Colorado,2020,General,LARIMER,2155135513,1248,66,1314,1110,84.47%
Colorado,2020,General,LARIMER,2155135514,1504,170,1674,1260,75.27%
Colorado,2020,General,LARIMER,2155135515,1313,104,1417,1179,83.20%
Colorado,2020,General,LARIMER,2155135516,1656,72,1728,1538,89.00%
Colorado,2020,General,LARIMER,2155135517,1401,112,1513,1309,86.52%
Colorado,2020,General,LARIMER,2155135518,1716,207,1923,1464,76.13%
Colorado,2020,General,LARIMER,2155135519,1434,126,1560,1249,80.06%
Colorado,2020,General,LARIMER,2155135520,1513,178,1691,1322,78.18%
Colorado,2020,General,LARIMER,2155135521,1288,113,1401,1145,81.73%
Colorado,2020,General,LARIMER,2155135522,1689,113,1802,1588,88.12%
Colorado,2020,General,LARIMER,2155135523,1168,73,1241,1034,83.32%
Colorado,2020,General,LARIMER,2155135524,1386,136,1522,1219,80.09%
Colorado,2020,General,LARIMER,2155135525,918,32,950,870,91.58%
Colorado,2020,General,LARIMER,2155135526,1539,90,1629,1419,87.11%
Colorado,2020,General,LARIMER,2155135527,1440,172,1612,1249,77.48%
Colorado,2020,General,LARIMER,2155135528,1704,155,1859,1496,80.47%
Colorado,2020,General,LARIMER,2155135529,1071,157,1228,917,74.67%
Colorado,2020,General,LARIMER,2155135530,1649,196,1845,1429,77.45%
Colorado,2020,General,LARIMER,2155135531,1099,67,1166,993,85.16%
Colorado,2020,General,LARIMER,2155135532,1533,166,1699,1303,76.69%
Colorado,2020,General,LARIMER,2155135533,1209,122,1331,998,74.98%
Colorado,2020,General,LARIMER,2155135534,896,121,1017,738,72.57%
Colorado,2020,General,LARIMER,2155135535,1655,160,1815,1423,78.40%
Colorado,2020,General,LARIMER,2155135536,1811,102,1913,1645,85.99%
Colorado,2020,General,LARIMER,2155135537,1669,102,1771,1554,87.75%
Colorado,2020,General,LARIMER,2155135538,1508,67,1575,1410,89.52%
Colorado,2020,General,LARIMER,2155135539,1483,117,1600,1345,84.06%
Colorado,2020,General,LARIMER,2155135540,777,76,853,645,75.62%
Colorado,2020,General,LARIMER,2155135541,1696,107,1803,1530,84.86%
Colorado,2020,General,LARIMER,2155135542,1910,317,2227,1649,74.05%
Colorado,2020,General,LARIMER,2155135543,826,70,896,729,81.36%
Colorado,2020,General,LARIMER,2155135544,953,136,1089,802,73.65%
Colorado,2020,General,LARIMER,2155135545,1038,128,1166,878,75.30%
Colorado,2020,General,LARIMER,2155135546,856,108,964,728,75.52%
Colorado,2020,General,LARIMER,2155135547,1027,157,1184,842,71.11%
Colorado,2020,General,LARIMER,2155135548,724,110,834,619,74.22%
Colorado,2020,General,LARIMER,2155135549,740,44,784,646,82.40%
Colorado,2020,General,LARIMER,2155235601,535,59,594,408,68.69%
Colorado,2020,General,LARIMER,2155235602,923,51,974,858,88.09%
Colorado,2020,General,LARIMER,2155235603,1499,76,1575,1401,88.95%
Colorado,2020,General,LARIMER,2155335701,1381,140,1521,1241,81.59%
Colorado,2020,General,LARIMER,2155335702,1121,84,1205,1029,85.39%
Colorado,2020,General,LARIMER,2155335703,1260,132,1392,1009,72.49%
Colorado,2020,General,LARIMER,2234935801,1173,83,1256,991,78.90%
Colorado,2020,General,LARIMER,2234935802,1053,53,1106,986,89.15%
Colorado,2020,General,LARIMER,2234935803,1164,54,1218,1088,89.33%
Colorado,2020,General,LARIMER,2234935804,1439,43,1482,1322,89.20%
Colorado,2020,General,LARIMER,2234935805,743,39,782,664,84.91%
Colorado,2020,General,LARIMER,2234935806,986,49,1035,934,90.24%
Colorado,2020,General,LARIMER,2234935807,793,50,843,730,86.60%
Colorado,2020,General,LARIMER,2234935808,1568,71,1639,1471,89.75%
Colorado,2020,General,LARIMER,2234935809,1418,70,1488,1281,86.09%
Colorado,2020,General,LARIMER,2234935810,1276,116,1392,1121,80.53%
Colorado,2020,General,LARIMER,2234935811,1945,218,2163,1697,78.46%
Colorado,2020,General,LARIMER,2234935812,1060,55,1115,989,88.70%
Colorado,2020,General,LARIMER,2234935813,1062,61,1123,993,88.42%
Colorado,2020,General,LARIMER,2234935814,981,48,1029,919,89.31%
Colorado,2020,General,LARIMER,2234935815,1081,47,1128,1025,90.87%
Colorado,2020,General,LARIMER,2235235101,1003,99,1102,848,76.95%
Colorado,2020,General,LARIMER,2235235102,243,13,256,230,89.84%
Colorado,2020,General,LAS ANIMAS,4356436001,216,30,246,192,78.05%
Colorado,2020,General,LAS ANIMAS,4356436002,89,12,101,80,79.21%
Colorado,2020,General,LAS ANIMAS,4356436003,830,109,939,689,73.38%
Colorado,2020,General,LAS ANIMAS,4356436004,701,107,808,581,71.91%
Colorado,2020,General,LAS ANIMAS,4356436005,474,96,570,412,72.28%
Colorado,2020,General,LAS ANIMAS,4356436006,482,69,551,403,73.14%
Colorado,2020,General,LAS ANIMAS,4356436007,544,89,633,465,73.46%
Colorado,2020,General,LAS ANIMAS,4356436008,352,59,411,287,69.83%
Colorado,2020,General,LAS ANIMAS,4356436009,584,73,657,513,78.08%
Colorado,2020,General,LAS ANIMAS,4356436010,863,146,1009,676,67.00%
Colorado,2020,General,LAS ANIMAS,4356436011,960,202,1162,714,61.45%
Colorado,2020,General,LAS ANIMAS,4356436012,780,170,950,618,65.05%
Colorado,2020,General,LAS ANIMAS,4356436013,597,135,732,486,66.39%
Colorado,2020,General,LAS ANIMAS,4356436014,621,111,732,500,68.31%
Colorado,2020,General,LAS ANIMAS,4356436015,894,158,1052,729,69.30%
Colorado,2020,General,LAS ANIMAS,4356436016,908,209,1117,717,64.19%
Colorado,2020,General,LINCOLN,4016437001,241,20,261,218,83.52%
Colorado,2020,General,LINCOLN,4016437002,426,55,481,361,75.05%
Colorado,2020,General,LINCOLN,4016437003,322,39,361,266,73.68%
Colorado,2020,General,LINCOLN,4016437004,202,23,225,185,82.22%
Colorado,2020,General,LINCOLN,4016437005,331,66,397,278,70.03%
Colorado,2020,General,LINCOLN,4016437006,250,20,270,220,81.48%
Colorado,2020,General,LINCOLN,4016437007,411,55,466,360,77.25%
Colorado,2020,General,LINCOLN,4016437008,59,4,63,58,92.06%
Colorado,2020,General,LINCOLN,4016437009,161,28,189,137,72.49%
Colorado,2020,General,LINCOLN,4016437010,183,8,191,171,89.53%
Colorado,2020,General,LINCOLN,4016437011,54,6,60,49,81.67%
Colorado,2020,General,LINCOLN,4016437012,37,3,40,31,77.50%
Colorado,2020,General,LINCOLN,4016437013,393,35,428,331,77.34%
Colorado,2020,General,LOGAN,4016538001,1060,103,1163,876,75.32%
Colorado,2020,General,LOGAN,4016538002,939,111,1050,781,74.38%
Colorado,2020,General,LOGAN,4016538003,649,121,770,489,63.51%
Colorado,2020,General,LOGAN,4016538004,1055,152,1207,786,65.12%
Colorado,2020,General,LOGAN,4016538005,803,108,911,624,68.50%
Colorado,2020,General,LOGAN,4016538006,732,64,796,641,80.53%
Colorado,2020,General,LOGAN,4016538007,1182,86,1268,1063,83.83%
Colorado,2020,General,LOGAN,4016538008,1107,71,1178,1038,88.12%
Colorado,2020,General,LOGAN,4016538009,1062,48,1110,995,89.64%
Colorado,2020,General,LOGAN,4016538010,934,43,977,845,86.49%
Colorado,2020,General,LOGAN,4016538011,584,36,620,527,85.00%
Colorado,2020,General,LOGAN,4016538012,362,46,408,337,82.60%
Colorado,2020,General,LOGAN,4016538013,636,40,676,569,84.17%
Colorado,2020,General,LOGAN,4016538014,394,28,422,355,84.12%
Colorado,2020,General,LOGAN,4016538015,505,36,541,456,84.29%
Colorado,2020,General,LOGAN,4016538016,232,14,246,224,91.06%
Colorado,2020,General,MESA,3075439001,1835,173,2008,1626,80.98%
Colorado,2020,General,MESA,3075439002,1770,176,1946,1610,82.73%
Colorado,2020,General,MESA,3075439003,1550,169,1719,1408,81.91%
Colorado,2020,General,MESA,3075439004,2180,296,2476,1943,78.47%
Colorado,2020,General,MESA,3075439005,1629,162,1791,1456,81.30%
Colorado,2020,General,MESA,3075439006,2306,261,2567,2014,78.46%
Colorado,2020,General,MESA,3075439007,1854,251,2105,1621,77.01%
Colorado,2020,General,MESA,3075439008,895,80,975,846,86.77%
Colorado,2020,General,MESA,3075439009,1037,82,1119,949,84.81%
Colorado,2020,General,MESA,3075439010,1127,104,1231,958,77.82%
Colorado,2020,General,MESA,3075439011,213,35,248,181,72.98%
Colorado,2020,General,MESA,3075439012,1475,117,1592,1327,83.35%
Colorado,2020,General,MESA,3075439013,2034,269,2303,1667,72.38%
Colorado,2020,General,MESA,3075439014,1445,114,1559,1261,80.89%
Colorado,2020,General,MESA,3075439015,1087,57,1144,1005,87.85%
Colorado,2020,General,MESA,3075439016,1003,91,1094,898,82.08%
Colorado,2020,General,MESA,3075439017,1053,159,1212,899,74.17%
Colorado,2020,General,MESA,3075439018,770,145,915,663,72.46%
Colorado,2020,General,MESA,3075439019,600,91,691,493,71.35%
Colorado,2020,General,MESA,3075439020,2025,216,2241,1784,79.61%
Colorado,2020,General,MESA,3075439021,2325,284,2609,1894,72.59%
Colorado,2020,General,MESA,3075439022,2486,313,2799,2036,72.74%
Colorado,2020,General,MESA,3075439023,2296,401,2697,1799,66.70%
Colorado,2020,General,MESA,3075439024,2702,479,3181,2019,63.47%
Colorado,2020,General,MESA,3075439025,2102,192,2294,1808,78.81%
Colorado,2020,General,MESA,3075439026,2479,411,2890,1920,66.44%
Colorado,2020,General,MESA,3075439027,2268,189,2457,2030,82.62%
Colorado,2020,General,MESA,3075439028,1644,88,1732,1503,86.78%
Colorado,2020,General,MESA,3075439029,2041,137,2178,1883,86.46%
Colorado,2020,General,MESA,3075539030,2995,471,3466,2518,72.65%
Colorado,2020,General,MESA,3075539031,1433,97,1530,1316,86.01%
Colorado,2020,General,MESA,3075539032,1169,87,1256,1076,85.67%
Colorado,2020,General,MESA,3075539033,2025,150,2175,1892,86.99%
Colorado,2020,General,MESA,3075539034,1005,87,1092,923,84.52%
Colorado,2020,General,MESA,3075539035,1523,133,1656,1443,87.14%
Colorado,2020,General,MESA,3075539036,1014,47,1061,972,91.61%
Colorado,2020,General,MESA,3075539037,1531,149,1680,1395,83.04%
Colorado,2020,General,MESA,3075539038,2303,278,2581,1980,76.71%
Colorado,2020,General,MESA,3075539039,2221,489,2710,1849,68.23%
Colorado,2020,General,MESA,3075539040,1960,271,2231,1754,78.62%
Colorado,2020,General,MESA,3075539041,1564,172,1736,1407,81.05%
Colorado,2020,General,MESA,3075539042,1723,98,1821,1616,88.74%
Colorado,2020,General,MESA,3075539043,2127,476,2603,1803,69.27%
Colorado,2020,General,MESA,3075539044,2396,440,2836,2009,70.84%
Colorado,2020,General,MESA,3075539045,2681,520,3201,2199,68.70%
Colorado,2020,General,MESA,3075539046,2438,250,2688,2070,77.01%
Colorado,2020,General,MESA,3075539047,1970,176,2146,1794,83.60%
Colorado,2020,General,MESA,3075539048,2190,159,2349,2026,86.25%
Colorado,2020,General,MESA,3075539049,2479,397,2876,2050,71.28%
Colorado,2020,General,MESA,3075539050,2030,237,2267,1735,76.53%
Colorado,2020,General,MESA,3075539051,1810,213,2023,1585,78.35%
Colorado,2020,General,MESA,3075539052,2433,315,2748,1993,72.53%
Colorado,2020,General,MESA,3075539053,2344,318,2662,1922,72.20%
Colorado,2020,General,MESA,3075539054,3146,605,3751,2422,64.57%
Colorado,2020,General,MESA,3075539055,1958,243,2201,1571,71.38%
Colorado,2020,General,MESA,3075539056,2726,353,3079,2336,75.87%
Colorado,2020,General,MESA,3075539057,2625,222,2847,2333,81.95%
Colorado,2020,General,MINERAL,3356240001,831,106,937,767,81.86%
Colorado,2020,General,MOFFAT,3085741001,1455,249,1704,1257,73.77%
Colorado,2020,General,MOFFAT,3085741002,751,111,862,611,70.88%
Colorado,2020,General,MOFFAT,3085741003,1273,111,1384,1115,80.56%
Colorado,2020,General,MOFFAT,3085741004,30,10,40,40,100.00%
Colorado,2020,General,MOFFAT,3085741005,1002,165,1167,807,69.15%
Colorado,2020,General,MOFFAT,3085741006,236,22,258,213,82.56%
Colorado,2020,General,MOFFAT,3085741007,844,118,962,700,72.77%
Colorado,2020,General,MOFFAT,3085741008,260,48,308,209,67.86%
Colorado,2020,General,MOFFAT,3085741009,866,141,1007,691,68.62%
Colorado,2020,General,MOFFAT,3085741010,112,8,120,99,82.50%
Colorado,2020,General,MOFFAT,3085741011,676,136,812,537,66.13%
Colorado,2020,General,MOFFAT,3085741012,480,78,558,405,72.58%
Colorado,2020,General,MOFFAT,3085741013,465,76,541,390,72.09%
Colorado,2020,General,MONTEZUMA,3065842001,483,45,528,436,82.58%
Colorado,2020,General,MONTEZUMA,3065842002,2505,396,2901,2206,76.04%
Colorado,2020,General,MONTEZUMA,3065842003,1840,185,2025,1665,82.22%
Colorado,2020,General,MONTEZUMA,3065842004,2059,220,2279,1834,80.47%
Colorado,2020,General,MONTEZUMA,3065842005,1120,120,1240,979,78.95%
Colorado,2020,General,MONTEZUMA,3065842006,770,67,837,386,46.12%
Colorado,2020,General,MONTEZUMA,3065842007,2283,372,2655,1822,68.63%
Colorado,2020,General,MONTEZUMA,3065842008,1613,315,1928,1361,70.59%
Colorado,2020,General,MONTEZUMA,3065842009,1733,409,2142,1348,62.93%
Colorado,2020,General,MONTEZUMA,3065842010,1479,208,1687,1251,74.16%
Colorado,2020,General,MONTEZUMA,3065842011,2636,424,3060,2343,76.57%
Colorado,2020,General,MONTROSE,3065843001,1285,87,1372,1125,82.00%
Colorado,2020,General,MONTROSE,3065843002,1112,55,1167,1019,87.32%
Colorado,2020,General,MONTROSE,3065843003,1623,194,1817,1310,72.10%
Colorado,2020,General,MONTROSE,3065843004,1401,205,1606,1174,73.10%
Colorado,2020,General,MONTROSE,3065843005,753,58,811,662,81.63%
Colorado,2020,General,MONTROSE,3065843006,990,66,1056,899,85.13%
Colorado,2020,General,MONTROSE,3065843007,883,99,982,711,72.40%
Colorado,2020,General,MONTROSE,3065843008,403,44,447,328,73.38%
Colorado,2020,General,MONTROSE,3065843009,1452,171,1623,1194,73.57%
Colorado,2020,General,MONTROSE,3065843010,129,16,145,110,75.86%
Colorado,2020,General,MONTROSE,3065843011,172,19,191,152,79.58%
Colorado,2020,General,MONTROSE,3065843012,1224,100,1324,1050,79.31%
Colorado,2020,General,MONTROSE,3065843013,1099,94,1193,942,78.96%
Colorado,2020,General,MONTROSE,3065843014,689,81,770,619,80.39%
Colorado,2020,General,MONTROSE,3065843015,20,2,22,18,81.82%
Colorado,2020,General,MONTROSE,3065843016,368,36,404,337,83.42%
Colorado,2020,General,MONTROSE,3065843017,1113,72,1185,978,82.53%
Colorado,2020,General,MONTROSE,3065843018,1152,65,1217,1082,88.91%
Colorado,2020,General,MONTROSE,3065843019,1093,61,1154,1022,88.56%
Colorado,2020,General,MONTROSE,3065843020,1562,167,1729,1323,76.52%
Colorado,2020,General,MONTROSE,3065843021,1167,79,1246,1035,83.07%
Colorado,2020,General,MONTROSE,3065843022,1229,64,1293,1131,87.47%
Colorado,2020,General,MONTROSE,3065843023,1376,132,1508,1257,83.36%
Colorado,2020,General,MONTROSE,3065843024,1282,108,1390,1169,84.10%
Colorado,2020,General,MONTROSE,3065843025,1324,82,1406,1223,86.98%
Colorado,2020,General,MONTROSE,3065843026,1156,63,1219,1073,88.02%
Colorado,2020,General,MONTROSE,3065843027,1308,121,1429,1045,73.13%
Colorado,2020,General,MONTROSE,3065843028,1382,109,1491,1171,78.54%
Colorado,2020,General,MORGAN,4016544001,1115,69,1184,968,81.76%
Colorado,2020,General,MORGAN,4016544002,692,36,728,619,85.03%
Colorado,2020,General,MORGAN,4016544003,1097,75,1172,848,72.35%
Colorado,2020,General,MORGAN,4016544004,993,77,1070,877,81.96%
Colorado,2020,General,MORGAN,4016544005,1053,83,1136,834,73.42%
Colorado,2020,General,MORGAN,4016544006,1207,99,1306,916,70.14%
Colorado,2020,General,MORGAN,4016544007,905,115,1020,667,65.39%
Colorado,2020,General,MORGAN,4016544008,864,126,990,640,64.65%
Colorado,2020,General,MORGAN,4016544009,967,125,1092,772,70.70%
Colorado,2020,General,MORGAN,4016544010,999,88,1087,823,75.71%
Colorado,2020,General,MORGAN,4016544011,1077,77,1154,997,86.40%
Colorado,2020,General,MORGAN,4016544012,304,22,326,272,83.44%
Colorado,2020,General,MORGAN,4016544013,532,38,570,462,81.05%
Colorado,2020,General,MORGAN,4016544014,819,83,902,653,72.39%
Colorado,2020,General,MORGAN,4016544015,944,74,1018,715,70.24%
Colorado,2020,General,MORGAN,4016544016,1042,78,1120,836,74.64%
Colorado,2020,General,MORGAN,4016544017,1215,106,1321,1024,77.52%
Colorado,2020,General,MORGAN,4016544018,1059,51,1110,937,84.41%
Colorado,2020,General,OTERO,4354745001,1012,90,1102,888,80.58%
Colorado,2020,General,OTERO,4354745002,558,77,635,455,71.65%
Colorado,2020,General,OTERO,4354745003,901,73,974,791,81.21%
Colorado,2020,General,OTERO,4354745004,637,53,690,552,80.00%
Colorado,2020,General,OTERO,4354745005,654,93,747,443,59.30%
Colorado,2020,General,OTERO,4354745006,500,40,540,451,83.52%
Colorado,2020,General,OTERO,4354745007,582,72,654,433,66.21%
Colorado,2020,General,OTERO,4354745008,709,58,767,548,71.45%
Colorado,2020,General,OTERO,4354745009,690,86,776,557,71.78%
Colorado,2020,General,OTERO,4354745010,592,71,663,455,68.63%
Colorado,2020,General,OTERO,4354745011,768,39,807,671,83.15%
Colorado,2020,General,OTERO,4354745012,874,78,952,699,73.42%
Colorado,2020,General,OTERO,4354745013,778,92,870,527,60.57%
Colorado,2020,General,OTERO,4354745014,906,67,973,760,78.11%
Colorado,2020,General,OTERO,4354745015,543,69,612,451,73.69%
Colorado,2020,General,OTERO,4354745016,815,54,869,703,80.90%
Colorado,2020,General,OTERO,4354745017,396,47,443,320,72.23%
Colorado,2020,General,OURAY,3065946001,565,52,617,507,82.17%
Colorado,2020,General,OURAY,3065946002,748,87,835,675,80.84%
Colorado,2020,General,OURAY,3065946003,1365,133,1498,1260,84.11%
Colorado,2020,General,OURAY,3065946004,661,58,719,606,84.28%
Colorado,2020,General,OURAY,3065946005,1101,138,1239,1002,80.87%
Colorado,2020,General,PARK,2026047008,939,122,1061,794,74.84%
Colorado,2020,General,PARK,2026047010,1474,190,1664,1261,75.78%
Colorado,2020,General,PARK,2026047011,995,108,1103,892,80.87%
Colorado,2020,General,PARK,2026047012,1871,216,2087,1641,78.63%
Colorado,2020,General,PARK,2026047013,1656,132,1788,1450,81.10%
Colorado,2020,General,PARK,5026047001,1733,356,2089,1483,70.99%
Colorado,2020,General,PARK,5026047002,932,180,1112,812,73.02%
Colorado,2020,General,PARK,5026047003,1059,131,1190,929,78.07%
Colorado,2020,General,PARK,5026047004,318,54,372,285,76.61%
Colorado,2020,General,PARK,5026047005,648,83,731,578,79.07%
Colorado,2020,General,PARK,5026047006,858,124,982,738,75.15%
Colorado,2020,General,PARK,5026047007,1059,178,1237,924,74.70%
Colorado,2020,General,PARK,5026047009,733,76,809,620,76.64%
Colorado,2020,General,PHILLIPS,4016548001,470,80,550,426,77.45%
Colorado,2020,General,PHILLIPS,4016548002,109,28,137,99,72.26%
Colorado,2020,General,PHILLIPS,4016548003,368,97,465,300,64.52%
Colorado,2020,General,PHILLIPS,4016548004,576,118,694,508,73.20%
Colorado,2020,General,PHILLIPS,4016548005,208,22,230,186,80.87%
Colorado,2020,General,PHILLIPS,4016548006,380,59,439,334,76.08%
Colorado,2020,General,PHILLIPS,4016548007,489,66,555,447,80.54%
Colorado,2020,General,PHILLIPS,4016548008,245,82,327,209,63.91%
Colorado,2020,General,PITKIN,3056149001,1410,112,1522,1251,82.19%
Colorado,2020,General,PITKIN,3056149002,1329,187,1516,1120,73.88%
Colorado,2020,General,PITKIN,3056149003,1171,120,1291,1021,79.09%
Colorado,2020,General,PITKIN,3056149004,1180,146,1326,1012,76.32%
Colorado,2020,General,PITKIN,3056149005,1236,135,1371,1076,78.48%
Colorado,2020,General,PITKIN,3056149006,2246,194,2440,1895,77.66%
Colorado,2020,General,PITKIN,3056149007,2253,169,2422,1995,82.37%
Colorado,2020,General,PITKIN,3056149008,871,82,953,776,81.43%
Colorado,2020,General,PITKIN,3056149009,1373,137,1510,1220,80.79%
Colorado,2020,General,PITKIN,3056149010,788,68,856,720,84.11%
Colorado,2020,General,PROWERS,4356450001,463,78,541,354,65.43%
Colorado,2020,General,PROWERS,4356450002,393,58,451,295,65.41%
Colorado,2020,General,PROWERS,4356450003,433,35,468,345,73.72%
Colorado,2020,General,PROWERS,4356450004,475,53,528,380,71.97%
Colorado,2020,General,PROWERS,4356450005,599,91,690,401,58.12%
Colorado,2020,General,PROWERS,4356450006,451,46,497,405,81.49%
Colorado,2020,General,PROWERS,4356450007,561,60,621,496,79.87%
Colorado,2020,General,PROWERS,4356450008,711,79,790,560,70.89%
Colorado,2020,General,PROWERS,4356450009,412,66,478,313,65.48%
Colorado,2020,General,PROWERS,4356450010,871,82,953,793,83.21%
Colorado,2020,General,PROWERS,4356450011,577,69,646,448,69.35%
Colorado,2020,General,PROWERS,4356450012,519,53,572,447,78.15%
Colorado,2020,General,PROWERS,4356450013,423,50,473,364,76.96%
Colorado,2020,General,PUEBLO,3034651020,227,27,254,184,72.44%
Colorado,2020,General,PUEBLO,3034651021,814,95,909,570,62.71%
Colorado,2020,General,PUEBLO,3034651036,700,46,746,603,80.83%
Colorado,2020,General,PUEBLO,3034651037,651,39,690,588,85.22%
Colorado,2020,General,PUEBLO,3034651038,799,88,887,652,73.51%
Colorado,2020,General,PUEBLO,3034651039,409,71,480,290,60.42%
Colorado,2020,General,PUEBLO,3034651040,451,43,494,393,79.55%
Colorado,2020,General,PUEBLO,3034651041,502,53,555,402,72.43%
Colorado,2020,General,PUEBLO,3034651042,488,136,624,384,61.54%
Colorado,2020,General,PUEBLO,3034651043,475,60,535,334,62.43%
Colorado,2020,General,PUEBLO,3034651044,484,109,593,361,60.88%
Colorado,2020,General,PUEBLO,3034651048,555,102,657,370,56.32%
Colorado,2020,General,PUEBLO,3034651049,454,48,502,352,70.12%
Colorado,2020,General,PUEBLO,3034651050,949,148,1097,647,58.98%
Colorado,2020,General,PUEBLO,3034651051,1036,99,1135,777,68.46%
Colorado,2020,General,PUEBLO,3034651052,737,80,817,573,70.13%
Colorado,2020,General,PUEBLO,3034651053,617,34,651,511,78.49%
Colorado,2020,General,PUEBLO,3034651054,516,62,578,377,65.22%
Colorado,2020,General,PUEBLO,3034651055,608,29,637,519,81.48%
Colorado,2020,General,PUEBLO,3034651056,586,19,605,515,85.12%
Colorado,2020,General,PUEBLO,3034651057,819,35,854,697,81.62%
Colorado,2020,General,PUEBLO,3034651058,718,19,737,647,87.79%
Colorado,2020,General,PUEBLO,3034651059,478,37,515,363,70.49%
Colorado,2020,General,PUEBLO,3034651060,1080,53,1133,936,82.61%
Colorado,2020,General,PUEBLO,3034651061,732,32,764,637,83.38%
Colorado,2020,General,PUEBLO,3034651062,780,44,824,685,83.13%
Colorado,2020,General,PUEBLO,3034651063,1192,73,1265,1000,79.05%
Colorado,2020,General,PUEBLO,3034651064,227,31,258,165,63.95%
Colorado,2020,General,PUEBLO,3034651065,144,7,151,138,91.39%
Colorado,2020,General,PUEBLO,3034651066,1017,51,1068,908,85.02%
Colorado,2020,General,PUEBLO,3034651067,669,70,739,531,71.85%
Colorado,2020,General,PUEBLO,3034651068,566,37,603,469,77.78%
Colorado,2020,General,PUEBLO,3034651069,893,55,948,692,73.00%
Colorado,2020,General,PUEBLO,3034651070,549,87,636,396,62.26%
Colorado,2020,General,PUEBLO,3034651071,845,78,923,609,65.98%
Colorado,2020,General,PUEBLO,3034651072,759,76,835,584,69.94%
Colorado,2020,General,PUEBLO,3034651073,674,92,766,476,62.14%
Colorado,2020,General,PUEBLO,3034651074,761,80,841,537,63.85%
Colorado,2020,General,PUEBLO,3034651075,898,92,990,669,67.58%
Colorado,2020,General,PUEBLO,3034651076,478,42,520,364,70.00%
Colorado,2020,General,PUEBLO,3034651077,554,103,657,364,55.40%
Colorado,2020,General,PUEBLO,3034651078,639,73,712,477,66.99%
Colorado,2020,General,PUEBLO,3034651079,684,94,778,475,61.05%
Colorado,2020,General,PUEBLO,3034651080,915,80,995,756,75.98%
Colorado,2020,General,PUEBLO,3034651081,796,64,860,616,71.63%
Colorado,2020,General,PUEBLO,3034651082,1451,73,1524,1178,77.30%
Colorado,2020,General,PUEBLO,3034651083,803,39,842,642,76.25%
Colorado,2020,General,PUEBLO,3034651084,894,51,945,737,77.99%
Colorado,2020,General,PUEBLO,3034651085,725,69,794,594,74.81%
Colorado,2020,General,PUEBLO,3034651086,1050,109,1159,878,75.75%
Colorado,2020,General,PUEBLO,3034651087,911,25,936,824,88.03%
Colorado,2020,General,PUEBLO,3034651088,1518,54,1572,1381,87.85%
Colorado,2020,General,PUEBLO,3034651209,1121,53,1174,1013,86.29%
Colorado,2020,General,PUEBLO,3034651210,554,63,617,458,74.23%
Colorado,2020,General,PUEBLO,3034651211,1113,87,1200,929,77.42%
Colorado,2020,General,PUEBLO,3034651212,894,112,1006,708,70.38%
Colorado,2020,General,PUEBLO,3034651213,1412,86,1498,1286,85.85%
Colorado,2020,General,PUEBLO,3034651214,1675,172,1847,1430,77.42%
Colorado,2020,General,PUEBLO,3034651215,1287,73,1360,1129,83.01%
Colorado,2020,General,PUEBLO,3034651216,965,69,1034,863,83.46%
Colorado,2020,General,PUEBLO,3034651217,769,55,824,685,83.13%
Colorado,2020,General,PUEBLO,3034651218,1395,94,1489,1260,84.62%
Colorado,2020,General,PUEBLO,3034651219,1267,63,1330,1133,85.19%
Colorado,2020,General,PUEBLO,3034651220,1188,98,1286,1056,82.12%
Colorado,2020,General,PUEBLO,3034751001,1579,215,1794,1323,73.75%
Colorado,2020,General,PUEBLO,3034751002,1834,148,1982,1540,77.70%
Colorado,2020,General,PUEBLO,3034751003,1539,108,1647,1300,78.93%
Colorado,2020,General,PUEBLO,3034751004,1213,66,1279,1076,84.13%
Colorado,2020,General,PUEBLO,3034751005,646,45,691,581,84.08%
Colorado,2020,General,PUEBLO,3034751006,577,134,711,482,67.79%
Colorado,2020,General,PUEBLO,3034751007,1053,64,1117,905,81.02%
Colorado,2020,General,PUEBLO,3034751008,1171,70,1241,1029,82.92%
Colorado,2020,General,PUEBLO,3034751009,718,50,768,586,76.30%
Colorado,2020,General,PUEBLO,3034751010,1358,305,1663,998,60.01%
Colorado,2020,General,PUEBLO,3034751011,978,89,1067,825,77.32%
Colorado,2020,General,PUEBLO,3034751015,1026,115,1141,809,70.90%
Colorado,2020,General,PUEBLO,3034751016,1005,139,1144,754,65.91%
Colorado,2020,General,PUEBLO,3034751017,1041,86,1127,883,78.35%
Colorado,2020,General,PUEBLO,3034751018,1650,196,1846,1286,69.66%
Colorado,2020,General,PUEBLO,3034751019,358,35,393,285,72.52%
Colorado,2020,General,PUEBLO,3034751022,655,81,736,469,63.72%
Colorado,2020,General,PUEBLO,3034751023,1065,108,1173,814,69.39%
Colorado,2020,General,PUEBLO,3034751024,887,89,976,761,77.97%
Colorado,2020,General,PUEBLO,3034751033,249,74,323,163,50.46%
Colorado,2020,General,PUEBLO,3034751034,785,150,935,522,55.83%
Colorado,2020,General,PUEBLO,3034751035,253,38,291,174,59.79%
Colorado,2020,General,PUEBLO,3034751113,790,63,853,584,68.46%
Colorado,2020,General,PUEBLO,3034751201,1613,144,1757,1424,81.05%
Colorado,2020,General,PUEBLO,3034751202,1265,120,1385,1101,79.49%
Colorado,2020,General,PUEBLO,3034751203,1426,166,1592,1230,77.26%
Colorado,2020,General,PUEBLO,3034751204,918,89,1007,792,78.65%
Colorado,2020,General,PUEBLO,3034751205,827,66,893,690,77.27%
Colorado,2020,General,PUEBLO,3034751206,1102,115,1217,889,73.05%
Colorado,2020,General,PUEBLO,3034751207,1126,91,1217,957,78.64%
Colorado,2020,General,PUEBLO,3034751208,1356,124,1480,1080,72.97%
Colorado,2020,General,PUEBLO,3036251012,1202,101,1303,943,72.37%
Colorado,2020,General,PUEBLO,3036251013,1058,151,1209,756,62.53%
Colorado,2020,General,PUEBLO,3036251014,897,117,1014,626,61.74%
Colorado,2020,General,PUEBLO,3036251025,761,180,941,494,52.50%
Colorado,2020,General,PUEBLO,3036251026,823,71,894,637,71.25%
Colorado,2020,General,PUEBLO,3036251027,790,91,881,548,62.20%
Colorado,2020,General,PUEBLO,3036251028,729,153,882,462,52.38%
Colorado,2020,General,PUEBLO,3036251029,578,63,641,386,60.22%
Colorado,2020,General,PUEBLO,3036251030,889,105,994,602,60.56%
Colorado,2020,General,PUEBLO,3036251031,1020,136,1156,658,56.92%
Colorado,2020,General,PUEBLO,3036251032,605,114,719,380,52.85%
Colorado,2020,General,PUEBLO,3036251045,173,35,208,125,60.10%
Colorado,2020,General,PUEBLO,3036251046,751,81,832,497,59.74%
Colorado,2020,General,PUEBLO,3036251047,566,90,656,376,57.32%
Colorado,2020,General,PUEBLO,3036251101,407,22,429,310,72.26%
Colorado,2020,General,PUEBLO,3036251102,718,29,747,598,80.05%
Colorado,2020,General,PUEBLO,3036251104,951,30,981,801,81.65%
Colorado,2020,General,PUEBLO,3354651301,1729,107,1836,1485,80.88%
Colorado,2020,General,PUEBLO,3354651302,1015,82,1097,889,81.04%
Colorado,2020,General,PUEBLO,3354651303,472,22,494,401,81.17%
Colorado,2020,General,PUEBLO,3354651401,824,33,857,748,87.28%
Colorado,2020,General,PUEBLO,3354651402,933,81,1014,810,79.88%
Colorado,2020,General,PUEBLO,3354651403,785,63,848,700,82.55%
Colorado,2020,General,PUEBLO,3354751106,1075,35,1110,954,85.95%
Colorado,2020,General,PUEBLO,3354751107,1465,57,1522,1301,85.48%
Colorado,2020,General,PUEBLO,3354751108,752,25,777,668,85.97%
Colorado,2020,General,PUEBLO,3354751109,717,44,761,593,77.92%
Colorado,2020,General,PUEBLO,3354751110,223,13,236,193,81.78%
Colorado,2020,General,PUEBLO,3354751111,545,56,601,442,73.54%
Colorado,2020,General,PUEBLO,3354751112,431,38,469,357,76.12%
Colorado,2020,General,PUEBLO,3356251103,827,29,856,727,84.93%
Colorado,2020,General,PUEBLO,3356251105,1305,43,1348,1166,86.50%
Colorado,2020,General,PUEBLO,3356251304,475,47,522,432,82.76%
Colorado,2020,General,RIO BLANCO,3085752001,914,130,1044,793,75.96%
Colorado,2020,General,RIO BLANCO,3085752002,685,110,795,592,74.47%
Colorado,2020,General,RIO BLANCO,3085752003,1221,152,1373,1052,76.62%
Colorado,2020,General,RIO BLANCO,3085752004,1360,110,1470,1215,82.65%
Colorado,2020,General,RIO BLANCO,3085752005,67,13,80,57,71.25%
Colorado,2020,General,RIO GRANDE,3356253001,339,51,390,286,73.33%
Colorado,2020,General,RIO GRANDE,3356253002,570,95,665,487,73.23%
Colorado,2020,General,RIO GRANDE,3356253003,778,113,891,684,76.77%
Colorado,2020,General,RIO GRANDE,3356253004,357,67,424,275,64.86%
Colorado,2020,General,RIO GRANDE,3356253005,443,47,490,391,79.80%
Colorado,2020,General,RIO GRANDE,3356253006,164,24,188,144,76.60%
Colorado,2020,General,RIO GRANDE,3356253007,476,66,542,435,80.26%
Colorado,2020,General,RIO GRANDE,3356253008,681,74,755,580,76.82%
Colorado,2020,General,RIO GRANDE,3356253009,484,50,534,381,71.35%
Colorado,2020,General,RIO GRANDE,3356253010,978,205,1183,872,73.71%
Colorado,2020,General,RIO GRANDE,3356253011,540,48,588,445,75.68%
Colorado,2020,General,RIO GRANDE,3356253012,404,53,457,325,71.12%
Colorado,2020,General,RIO GRANDE,3356253013,384,43,427,342,80.09%
Colorado,2020,General,RIO GRANDE,3356253014,493,82,575,421,73.22%
Colorado,2020,General,RIO GRANDE,3356253015,425,38,463,309,66.74%
Colorado,2020,General,ROUTT,3082654001,906,100,1006,829,82.41%
Colorado,2020,General,ROUTT,3082654002,646,49,695,561,80.72%
Colorado,2020,General,ROUTT,3082654003,1133,78,1211,1038,85.71%
Colorado,2020,General,ROUTT,3082654004,652,59,711,598,84.11%
Colorado,2020,General,ROUTT,3082654005,1379,160,1539,1187,77.13%
Colorado,2020,General,ROUTT,3082654006,1256,112,1368,1139,83.26%
Colorado,2020,General,ROUTT,3082654007,558,63,621,494,79.55%
Colorado,2020,General,ROUTT,3082654008,992,124,1116,849,76.08%
Colorado,2020,General,ROUTT,3082654009,946,92,1038,863,83.14%
Colorado,2020,General,ROUTT,3082654010,537,66,603,485,80.43%
Colorado,2020,General,ROUTT,3082654011,1384,228,1612,1196,74.19%
Colorado,2020,General,ROUTT,3082654012,805,91,896,743,82.92%
Colorado,2020,General,ROUTT,3082654013,1232,134,1366,1109,81.19%
Colorado,2020,General,ROUTT,3082654014,966,101,1067,883,82.76%
Colorado,2020,General,ROUTT,3082654015,1574,158,1732,1412,81.52%
Colorado,2020,General,ROUTT,3082654016,1541,176,1717,1377,80.20%
Colorado,2020,General,ROUTT,3082654017,1265,252,1517,1086,71.59%
Colorado,2020,General,ROUTT,3082654018,1429,247,1676,1199,71.54%
Colorado,2020,General,SAGUACHE,3356255001,1139,165,1304,960,73.62%
Colorado,2020,General,SAGUACHE,3356255002,110,16,126,102,80.95%
Colorado,2020,General,SAGUACHE,3356255003,281,42,323,228,70.59%
Colorado,2020,General,SAGUACHE,3356255004,273,65,338,209,61.83%
Colorado,2020,General,SAGUACHE,3356255005,1035,127,1162,893,76.85%
Colorado,2020,General,SAGUACHE,3356255006,677,56,733,522,71.21%
Colorado,2020,General,SAGUACHE,3356255007,682,65,747,530,70.95%
Colorado,2020,General,SAN JUAN,3065956001,656,116,772,571,73.96%
Colorado,2020,General,SAN MIGUEL,3065857001,1955,283,2238,1704,76.14%
Colorado,2020,General,SAN MIGUEL,3065857002,1345,132,1477,1209,81.86%
Colorado,2020,General,SAN MIGUEL,3065857003,699,55,754,626,83.02%
Colorado,2020,General,SAN MIGUEL,3065857004,1029,113,1142,892,78.11%
Colorado,2020,General,SAN MIGUEL,3065857005,93,14,107,84,78.50%
Colorado,2020,General,SAN MIGUEL,3065857006,792,154,946,675,71.35%
Colorado,2020,General,SEDGWICK,4016558001,404,39,443,369,83.30%
Colorado,2020,General,SEDGWICK,4016558002,330,45,375,282,75.20%
Colorado,2020,General,SEDGWICK,4016558003,349,36,385,291,75.58%
Colorado,2020,General,SEDGWICK,4016558004,271,38,309,233,75.40%
Colorado,2020,General,SEDGWICK,4016558005,337,61,398,292,73.37%
Colorado,2020,General,SUMMIT,2086159001,1376,296,1672,1141,68.24%
Colorado,2020,General,SUMMIT,2086159002,1518,327,1845,1278,69.27%
Colorado,2020,General,SUMMIT,2086159003,861,132,993,743,74.82%
Colorado,2020,General,SUMMIT,2086159004,1624,230,1854,1400,75.51%
Colorado,2020,General,SUMMIT,2086159005,1565,248,1813,1380,76.12%
Colorado,2020,General,SUMMIT,2086159006,819,95,914,724,79.21%
Colorado,2020,General,SUMMIT,2086159007,1099,288,1387,900,64.89%
Colorado,2020,General,SUMMIT,2086159008,598,135,733,508,69.30%
Colorado,2020,General,SUMMIT,2086159009,1427,358,1785,1182,66.22%
Colorado,2020,General,SUMMIT,2086159010,944,107,1051,836,79.54%
Colorado,2020,General,SUMMIT,2086159011,771,97,868,701,80.76%
Colorado,2020,General,SUMMIT,2086159012,383,36,419,335,79.95%
Colorado,2020,General,SUMMIT,2086159013,1140,178,1318,1054,79.97%
Colorado,2020,General,SUMMIT,2086159014,745,201,946,640,67.65%
Colorado,2020,General,SUMMIT,2086159015,977,156,1133,866,76.43%
Colorado,2020,General,SUMMIT,2086159016,956,186,1142,828,72.50%
Colorado,2020,General,SUMMIT,2086159017,1254,208,1462,1111,75.99%
Colorado,2020,General,SUMMIT,2086159018,1102,263,1365,928,67.99%
Colorado,2020,General,SUMMIT,2086159019,1230,185,1415,1075,75.97%
Colorado,2020,General,SUMMIT,2086159020,1243,250,1493,1052,70.46%
Colorado,2020,General,TELLER,5023960001,1609,252,1861,1441,77.43%
Colorado,2020,General,TELLER,5023960002,1524,269,1793,1368,76.30%
Colorado,2020,General,TELLER,5023960003,1756,325,2081,1544,74.20%
Colorado,2020,General,TELLER,5023960004,1698,224,1922,1523,79.24%
Colorado,2020,General,TELLER,5023960005,982,107,1089,881,80.90%
Colorado,2020,General,TELLER,5023960006,456,73,529,393,74.29%
Colorado,2020,General,TELLER,5023960007,2008,248,2256,1786,79.17%
Colorado,2020,General,TELLER,5023960008,1579,178,1757,1443,82.13%
Colorado,2020,General,TELLER,5023960009,1734,208,1942,1557,80.18%
Colorado,2020,General,TELLER,5023960010,1346,221,1567,1200,76.58%
Colorado,2020,General,TELLER,5023960011,2079,339,2418,1832,75.77%
Colorado,2020,General,TELLER,5023960012,1358,180,1538,1215,79.00%
Colorado,2020,General,TELLER,5023960013,1079,200,1279,904,70.68%
Colorado,2020,General,WASHINGTON,4016461001,139,9,148,135,91.22%
Colorado,2020,General,WASHINGTON,4016461002,1719,185,1904,1548,81.30%
Colorado,2020,General,WASHINGTON,4016461003,181,8,189,171,90.48%
Colorado,2020,General,WASHINGTON,4016461004,628,71,699,568,81.26%
Colorado,2020,General,WASHINGTON,4016461005,261,27,288,218,75.69%
Colorado,2020,General,WASHINGTON,4016461006,420,34,454,388,85.46%
Colorado,2020,General,WELD,4014862118,1390,90,1480,1228,82.97%
Colorado,2020,General,WELD,4014862119,772,71,843,674,79.95%
Colorado,2020,General,WELD,4014862126,1713,136,1849,1489,80.53%
Colorado,2020,General,WELD,4014862127,1380,125,1505,1176,78.14%
Colorado,2020,General,WELD,4014862128,1003,63,1066,904,84.80%
Colorado,2020,General,WELD,4014862134,1870,115,1985,1673,84.28%
Colorado,2020,General,WELD,4014862152,865,53,918,786,85.62%
Colorado,2020,General,WELD,4014862316,1069,66,1135,940,82.82%
Colorado,2020,General,WELD,4016362100,1606,158,1764,1427,80.90%
Colorado,2020,General,WELD,4016362101,415,40,455,375,82.42%
Colorado,2020,General,WELD,4016362102,297,19,316,278,87.97%
Colorado,2020,General,WELD,4016362103,553,44,597,496,83.08%
Colorado,2020,General,WELD,4016362104,1096,92,1188,959,80.72%
Colorado,2020,General,WELD,4016362144,947,62,1009,825,81.76%
Colorado,2020,General,WELD,4016362308,898,46,944,793,84.00%
Colorado,2020,General,WELD,4016362310,1156,121,1277,907,71.03%
Colorado,2020,General,WELD,4016362311,1394,237,1631,1006,61.68%
Colorado,2020,General,WELD,4016362312,579,36,615,522,84.88%
Colorado,2020,General,WELD,4016362314,1929,150,2079,1529,73.54%
Colorado,2020,General,WELD,4016362320,1220,96,1316,998,75.84%
Colorado,2020,General,WELD,4016362327,2307,214,2521,1854,73.54%
Colorado,2020,General,WELD,4016362342,1035,65,1100,889,80.82%
Colorado,2020,General,WELD,4016362345,1153,91,1244,1028,82.64%
Colorado,2020,General,WELD,4134862120,603,29,632,533,84.34%
Colorado,2020,General,WELD,4134862124,1152,85,1237,1015,82.05%
Colorado,2020,General,WELD,4134862125,1084,57,1141,1023,89.66%
Colorado,2020,General,WELD,4134862135,1163,57,1220,1071,87.79%
Colorado,2020,General,WELD,4134862136,1349,87,1436,1166,81.20%
Colorado,2020,General,WELD,4134862146,601,56,657,411,62.56%
Colorado,2020,General,WELD,4134862150,849,54,903,730,80.84%
Colorado,2020,General,WELD,4134862151,993,96,1089,892,81.91%
Colorado,2020,General,WELD,4134862212,1454,135,1589,1272,80.05%
Colorado,2020,General,WELD,4134862213,2290,219,2509,1916,76.37%
Colorado,2020,General,WELD,4134862214,1411,60,1471,1295,88.04%
Colorado,2020,General,WELD,4134862215,1326,74,1400,1193,85.21%
Colorado,2020,General,WELD,4134862217,1783,163,1946,1487,76.41%
Colorado,2020,General,WELD,4134862221,1167,86,1253,1008,80.45%
Colorado,2020,General,WELD,4134862222,1539,90,1629,1385,85.02%
Colorado,2020,General,WELD,4134862223,1338,99,1437,1217,84.69%
Colorado,2020,General,WELD,4134862224,861,64,925,739,79.89%
Colorado,2020,General,WELD,4134862225,1382,150,1532,1202,78.46%
Colorado,2020,General,WELD,4134862226,612,91,703,531,75.53%
Colorado,2020,General,WELD,4134862228,1771,162,1933,1445,74.75%
Colorado,2020,General,WELD,4134862235,989,47,1036,883,85.23%
Colorado,2020,General,WELD,4134862238,1534,198,1732,1236,71.36%
Colorado,2020,General,WELD,4134862241,861,77,938,740,78.89%
Colorado,2020,General,WELD,4134862243,1424,111,1535,1262,82.21%
Colorado,2020,General,WELD,4134862246,2636,204,2840,2207,77.71%
Colorado,2020,General,WELD,4134862248,874,191,1065,677,63.57%
Colorado,2020,General,WELD,4134862250,1286,175,1461,1073,73.44%
Colorado,2020,General,WELD,4134862253,1091,74,1165,965,82.83%
Colorado,2020,General,WELD,4134862255,1416,129,1545,1244,80.52%
Colorado,2020,General,WELD,4134862309,921,95,1016,777,76.48%
Colorado,2020,General,WELD,4134862326,1250,91,1341,997,74.35%
Colorado,2020,General,WELD,4134862331,1597,100,1697,1320,77.78%
Colorado,2020,General,WELD,4134862333,792,81,873,604,69.19%
Colorado,2020,General,WELD,4134862338,124,6,130,107,82.31%
Colorado,2020,General,WELD,4134862341,1221,111,1332,984,73.87%
Colorado,2020,General,WELD,4134962145,14,3,17,11,64.71%
Colorado,2020,General,WELD,4135062105,1570,236,1806,1005,55.65%
Colorado,2020,General,WELD,4135062106,1693,170,1863,1135,60.92%
Colorado,2020,General,WELD,4135062107,1533,312,1845,1005,54.47%
Colorado,2020,General,WELD,4135062108,1587,261,1848,1158,62.66%
Colorado,2020,General,WELD,4135062109,1124,107,1231,882,71.65%
Colorado,2020,General,WELD,4135062110,954,234,1188,681,57.32%
Colorado,2020,General,WELD,4135062111,1573,210,1783,1222,68.54%
Colorado,2020,General,WELD,4135062112,1257,280,1537,946,61.55%
Colorado,2020,General,WELD,4135062113,965,310,1275,740,58.04%
Colorado,2020,General,WELD,4135062114,1133,90,1223,990,80.95%
Colorado,2020,General,WELD,4135062132,1169,77,1246,1037,83.23%
Colorado,2020,General,WELD,4135062137,1192,209,1401,819,58.46%
Colorado,2020,General,WELD,4135062141,1416,178,1594,939,58.91%
Colorado,2020,General,WELD,4135062142,527,121,648,359,55.40%
Colorado,2020,General,WELD,4135062147,712,126,838,455,54.30%
Colorado,2020,General,WELD,4135062211,1474,162,1636,1120,68.46%
Colorado,2020,General,WELD,4135062220,855,65,920,746,81.09%
Colorado,2020,General,WELD,4135062236,1818,110,1928,1458,75.62%
Colorado,2020,General,WELD,4135062247,1025,161,1186,789,66.53%
Colorado,2020,General,WELD,4135062249,1525,134,1659,1275,76.85%
Colorado,2020,General,WELD,4135062317,1138,323,1461,941,64.41%
Colorado,2020,General,WELD,4135062318,1002,118,1120,791,70.63%
Colorado,2020,General,WELD,4135062319,1329,210,1539,979,63.61%
Colorado,2020,General,WELD,4135062321,1549,272,1821,1003,55.08%
Colorado,2020,General,WELD,4135062322,1726,201,1927,1266,65.70%
Colorado,2020,General,WELD,4135062323,1662,139,1801,1249,69.35%
Colorado,2020,General,WELD,4135062324,1792,194,1986,1386,69.79%
Colorado,2020,General,WELD,4135062325,1429,244,1673,1039,62.10%
Colorado,2020,General,WELD,4135062329,1466,197,1663,1126,67.71%
Colorado,2020,General,WELD,4135062330,1251,166,1417,938,66.20%
Colorado,2020,General,WELD,4135062343,974,92,1066,792,74.30%
Colorado,2020,General,WELD,4136362202,504,27,531,417,78.53%
Colorado,2020,General,WELD,4136362300,1521,122,1643,1218,74.13%
Colorado,2020,General,WELD,4136362301,1566,125,1691,1181,69.84%
Colorado,2020,General,WELD,4136362302,1771,138,1909,1415,74.12%
Colorado,2020,General,WELD,4136362303,928,77,1005,773,76.92%
Colorado,2020,General,WELD,4136362304,1538,94,1632,1258,77.08%
Colorado,2020,General,WELD,4136362313,695,40,735,587,79.86%
Colorado,2020,General,WELD,4234862117,1730,67,1797,1557,86.64%
Colorado,2020,General,WELD,4234862131,1369,67,1436,1242,86.49%
Colorado,2020,General,WELD,4234862138,2422,128,2550,2126,83.37%
Colorado,2020,General,WELD,4234862153,1129,70,1199,1021,85.15%
Colorado,2020,General,WELD,4234862227,1470,149,1619,1326,81.90%
Colorado,2020,General,WELD,4234862230,949,71,1020,856,83.92%
Colorado,2020,General,WELD,4234862232,1054,87,1141,875,76.69%
Colorado,2020,General,WELD,4234862244,1689,152,1841,1493,81.10%
Colorado,2020,General,WELD,4234862245,1814,144,1958,1624,82.94%
Colorado,2020,General,WELD,4234862251,902,48,950,808,85.05%
Colorado,2020,General,WELD,4234862252,1064,105,1169,908,77.67%
Colorado,2020,General,WELD,4234962115,1197,114,1311,1066,81.31%
Colorado,2020,General,WELD,4234962116,1094,105,1199,935,77.98%
Colorado,2020,General,WELD,4234962121,1733,59,1792,1581,88.23%
Colorado,2020,General,WELD,4234962122,924,71,995,798,80.20%
Colorado,2020,General,WELD,4234962123,1495,138,1633,1276,78.14%
Colorado,2020,General,WELD,4234962129,156,5,161,145,90.06%
Colorado,2020,General,WELD,4234962130,2198,122,2320,2006,86.47%
Colorado,2020,General,WELD,4234962133,1981,136,2117,1780,84.08%
Colorado,2020,General,WELD,4234962139,1610,104,1714,1464,85.41%
Colorado,2020,General,WELD,4234962140,1570,92,1662,1417,85.26%
Colorado,2020,General,WELD,4234962143,2360,55,2415,2183,90.39%
Colorado,2020,General,WELD,4234962148,1036,77,1113,940,84.46%
Colorado,2020,General,WELD,4234962149,762,70,832,639,76.80%
Colorado,2020,General,WELD,4234962229,1241,59,1300,1125,86.54%
Colorado,2020,General,WELD,4234962231,387,20,407,356,87.47%
Colorado,2020,General,WELD,4236362200,1592,89,1681,1407,83.70%
Colorado,2020,General,WELD,4236362203,1084,76,1160,998,86.03%
Colorado,2020,General,WELD,4236362204,1042,89,1131,922,81.52%
Colorado,2020,General,WELD,4236362205,1182,105,1287,1021,79.33%
Colorado,2020,General,WELD,4236362206,1112,79,1191,967,81.19%
Colorado,2020,General,WELD,4236362207,1937,156,2093,1668,79.69%
Colorado,2020,General,WELD,4236362208,1050,49,1099,955,86.90%
Colorado,2020,General,WELD,4236362209,1904,145,2049,1655,80.77%
Colorado,2020,General,WELD,4236362210,1391,107,1498,1230,82.11%
Colorado,2020,General,WELD,4236362216,966,59,1025,882,86.05%
Colorado,2020,General,WELD,4236362218,1929,108,2037,1674,82.18%
Colorado,2020,General,WELD,4236362219,1092,83,1175,963,81.96%
Colorado,2020,General,WELD,4236362233,1847,182,2029,1517,74.77%
Colorado,2020,General,WELD,4236362234,1294,109,1403,1018,72.56%
Colorado,2020,General,WELD,4236362237,2016,84,2100,1805,85.95%
Colorado,2020,General,WELD,4236362239,958,80,1038,836,80.54%
Colorado,2020,General,WELD,4236362240,1731,144,1875,1553,82.83%
Colorado,2020,General,WELD,4236362242,1704,140,1844,1478,80.15%
Colorado,2020,General,WELD,4236362254,960,62,1022,868,84.93%
Colorado,2020,General,WELD,4236362305,1273,56,1329,1135,85.40%
Colorado,2020,General,WELD,4236362306,1279,95,1374,1114,81.08%
Colorado,2020,General,WELD,4236362307,3641,167,3808,3367,88.42%
Colorado,2020,General,WELD,4236362315,4,0,4,0,0.00%
Colorado,2020,General,WELD,4236362328,301,11,312,271,86.86%
Colorado,2020,General,WELD,4236362332,1041,63,1104,961,87.05%
Colorado,2020,General,WELD,4236362334,1822,174,1996,1650,82.67%
Colorado,2020,General,WELD,4236362335,1393,74,1467,1278,87.12%
Colorado,2020,General,WELD,4236362336,830,54,884,757,85.63%
Colorado,2020,General,WELD,4236362337,1308,129,1437,1101,76.62%
Colorado,2020,General,WELD,4236362339,1850,82,1932,1664,86.13%
Colorado,2020,General,WELD,4236362340,2046,175,2221,1644,74.02%
Colorado,2020,General,WELD,4236362344,1217,81,1298,1115,85.90%
Colorado,2020,General,WELD,4236362346,1377,93,1470,1301,88.50%
Colorado,2020,General,YUMA,4016563001,462,28,490,419,85.51%
Colorado,2020,General,YUMA,4016563002,455,47,502,376,74.90%
Colorado,2020,General,YUMA,4016563003,237,22,259,198,76.45%
Colorado,2020,General,YUMA,4016563004,753,55,808,667,82.55%
Colorado,2020,General,YUMA,4016563005,186,7,193,162,83.94%
Colorado,2020,General,YUMA,4016563006,568,41,609,509,83.58%
Colorado,2020,General,YUMA,4016563007,131,8,139,124,89.21%
Colorado,2020,General,YUMA,4016563008,213,14,227,191,84.14%
Colorado,2020,General,YUMA,4016563009,344,16,360,314,87.22%
Colorado,2020,General,YUMA,4016563010,331,12,343,298,86.88%
Colorado,2020,General,YUMA,4016563011,478,43,521,404,77.54%
Colorado,2020,General,YUMA,4016563012,567,32,599,492,82.14%
Colorado,2020,General,YUMA,4016563013,543,38,581,449,77.28%
Colorado,2020,General,YUMA,4016563014,505,36,541,416,76.89%
